Predsjednik	predsjednik	Ncmsn
Upravnog	upravan	Agpnsgy
vijeća	vijeće	Ncnsg
Hrvatskog	hrvatski	Agpmsgy
zavoda	zavod	Ncmsg
za	za	Sa
zdravstveno	zdravstven	Agpnsay
osiguranje	osiguranje	Ncnsa
prof.	prof.	Y
dr.	dr.	Y
sc.	sc.	Y
Marko	Marko	Npmsn
Duvnjak	Duvnjak	Npmsn
,	,	Z
dr.	dr.	Y
med	med	Ncmsan
.	.	Z
,	,	Z
v.	v.	Y
r.	r.	Y

