Pokazatelji	pokazatelj	Ncmpn
profila	profil	Ncmsg
rizičnosti	rizičnost	Ncfsg
a	a	Cc
)	)	Z
godišnja	godišnji	Agpfsny
stopa	stopa	Ncfsn
rasta	rast	Ncmsg
udjela	udjel	Ncmsg
loših	loš	Agpmpgy
plasmana	plasman	Ncmpg
b	b	X
)	)	Z
pokrivenost	pokrivenost	Ncfsn
loših	loš	Agpmpgy
plasmana	plasman	Ncmpg
ispravcima	ispravak	Ncmpi
vrijednosti	vrijednost	Ncfsg

*	*	Pq3n-n
Ako	ako	Cs
je	biti	Var3s
kreditna	kreditan	Agpfsny
institucija	institucija	Ncfsn
odredila	odrediti	Vmp-sf
više	mnogo	Rgc
razina	razina	Ncfpg
za	za	Sa
različite	različit	Agpfpay
opcije	opcija	Ncfpa
,	,	Z
upisuje	upisivati	Vmr3s
se	sebe	Px--sa
razina	razina	Ncfsn
na	na	Sl
kojoj	koji	Pi-fsl
se	sebe	Px--sa
pokreće	pokretati	Vmr3s
prva	prvi	Mlofsn
opcija	opcija	Ncfsn
.	.	Z

**	**	Pq3n-n
Ako	ako	Cs
je	biti	Var3s
kreditna	kreditan	Agpfsny
institucija	institucija	Ncfsn
obrazložila	obrazložiti	Vmp-sf
zašto	zašto	Rgp
ne	ne	Qz
primjenjuje	primjenjivati	Vmr3s
ovaj	ovaj	Pd-msn
pokazatelj	pokazatelj	Ncmsn
,	,	Z
u	u	Sa
razine	razina	Ncfpa
pokretanja	pokretanje	Ncnsg
opcija	opcija	Ncfpg
plana	plan	Ncmsg
oporavka	oporavak	Ncmsg
upisuje	upisivati	Vmr3s
»	»	Z
nije	biti	Var3s
primjenjivo	primjenjiv	Agpnsny
«	«	Z
.	.	Z

***	**	Ncmpn
Upisuju	upisivati	Vmr3p
samo	samo	Rgp
kreditne	kreditan	Agpfpny
institucije	institucija	Ncfpn
kojima	koji	Pi-fpi
je	biti	Var3s
na	na	Sl
temelju	temelj	Ncmsl
članka	članak	Ncmsg
225.	225.	Mdo

Zakona	zakon	Ncmsg
o	o	Sl
kreditnim	kreditan	Agpfply
institucijama	institucija	Ncfpl
(	(	Z
»	i	Agpfpny
Narodne	narodni	Agpfpny
novine	novina	Ncfpn
«	«	Z
,	,	Z
br.	br.	Y
159/2013.	159/2013.	Mdo
i	i	Cc
19/2015.	19/2015.	Mds
)	)	Z
naložen	naložiti	Appmsnn
poseban	poseban	Agpmsann
zahtjev	zahtjev	Ncmsan
za	za	Sa
likvidnost	likvidnost	Ncfsa
.	.	Z

****	***i	Agpfsny
Kreditna	kreditan	Agpfsny
institucija	institucija	Ncfsn
dodaje	dodavati	Vmr3s
retke	redak	Ncmpa
za	za	Sa
dodatne	dodatan	Agpmpay
pokazatelje	pokazatelj	Ncmpa
plana	plan	Ncmsg
oporavka	oporavak	Ncmsg
koje	koji	Pi-mpa
je	biti	Var3s
utvrdila	utvrditi	Vmp-sf
,	,	Z
a	a	Cc
nisu	biti	Var3p
navedeni	navesti	Appmpny
u	u	Sl
tablici	tablica	Ncfsl
.	.	Z

PRILOG	prilog	Ncmsn
2.	2.	Mdo

Ključne	ključan	Agpfpny
funkcije	funkcija	Ncfpn

Funkcije	funkcija	Ncfsg
Ima	imati	Vmr3s
li	li	Cs
prekid	prekid	Ncmsan
pružanja	pružanje	Ncnsg
te	taj	Pd-fsg
usluge	usluga	Ncfsg
utjecaj	utjecaj	Ncmsn
na	na	Sa
treće	treći	Ncfpa
strane	strana	Ncfsg
i	i	Cc
financijski	financijski	Agpmsny
sustav	sustav	Ncmsn
u	u	Sl
cjelini	cjelina	Ncfsl
?	?	Z

Je	biti	Var3s
li	li	Qq
tržište	tržište	Ncnsn
predmetne	predmetni	Agpfsgy
usluge	usluga	Ncfsg
koncentrirano	koncentrirati	Appnsny
?	?	Z

Postoji	postojati	Vmr3s
li	li	Qq
mogućnost	mogućnost	Ncfsn
da	da	Cs
pružanje	pružanje	Ncnsn
predmetne	predmetni	Agpfsgy
usluge	usluga	Ncfsg
adekvatno	adekvatno	Rgp
preuzme	preuzeti	Vmr3s
drugi	drugi	Mlomsn
pružatelj	pružatelj	Ncmsn
usluga	usluga	Ncfpg
?	?	Z

Je	biti	Var3s
li	li	Qq
funkcija	funkcija	Ncfsn
ključna	ključan	Agpfsny
?	?	Z

Ključne	ključan	Agpfpay
usluge	usluga	Ncfpa
za	za	Sa
pružanje	pružanje	Ncnsa
ključnih	ključan	Agpfpgy
funkcija	funkcija	Ncfpg

PRILOG	prilog	Ncmsn
3.	3.	Mdo

Temeljne	temeljan	Agpfpny
poslovne	poslovan	Agpfpny
linije	linija	Ncfpn

Temeljne	temeljan	Agpfpny
poslovne	poslovan	Agpfpny
linije	linija	Ncfpn
Obrazloženje	obrazloženje	Ncnsn
zašto	zašto	Rgp
se	sebe	Px--sa
poslovna	poslovan	Agpfsny
linija	linija	Ncfsn
smatra	smatrati	Vmr3s
temeljnom	temeljan	Agpfsiy

PRILOG	prilog	Ncmsn
4.	4.	Mdo

Opcije	opcija	Ncfpn
oporavka	oporavak	Ncmsg

Naziv	naziv	Ncmsn
opcije	opcija	Ncfsg
Područja	područje	Ncnsg
opcija	opcija	Ncfpg
Primjenjuje	primjenjivati	Vmr3s
li	li	Qq
se	sebe	Px--sa
u	u	Sl
fazi	faza	Ncfsl
rane	ran	Agpfsgy
intervencije	intervencija	Ncfsg
?	?	Z

Kapital	kapital	Ncmsn
Likvidnost	likvidnost	Ncfsn
Financijska	financijski	Agpfsny
poluga	poluga	Ncfsn
Upravljanje	upravljanje	Ncnsn
rizicima	rizik	Ncmpi
Restrukturiranje	restrukturiranje	Ncnsn
obveza	obveza	Ncfpg
Ostalo	ostati	Vmp-sn

PRILOG	prilog	Ncmsn
5.	5.	Mdo

Scenariji	scenarij	Ncmpn

Naziv	naziv	Ncmsn
scenarija	scenarij	Ncmsg
Vrsta	vrsta	Ncfsn
scenarija	scenarij	Ncmsg
Brzo	brzo	Rgp
/	/	Z
sporo	sporo	Rgp
razvijajući	razvijati	Agpmpny
događaji	događaj	Ncmpn
Šokovi	šok	Ncmpn
i	i	Cc
njihovi	njihov	Ps3mpn
parametri	parametar	Ncmpn
Primjena	primjena	Ncfsn
obratnog	obratan	Agpnsgy
testiranja	testiranje	Ncnsg
otpornosti	otpornost	Ncfsg
na	na	Sa
stres	stres	Ncmsan
Razina	razina	Ncfsn
pokazatelja	pokazatelj	Ncmpg
nakon	nakon	Sg
primijenjenog	primijeniti	Agpmsgy
šoka	šok	Ncmsg
Opcije	opcija	Ncfsg
primjenjive	primjenjiv	Agpfsgy
u	u	Sl
scenariju	scenarij	Ncmsl
Razina	razina	Ncfsn
pokazatelja	pokazatelj	Ncmpg
nakon	nakon	Sg
primijenjene	primijeniti	Agpfsgy
opcije	opcija	Ncfsg
Specifični	specifičan	Agpmsny
Sistemski	sistemski	Agpmsny
Kombinirani	kombiniran	Agpmsny

