ministar	ministar	Ncmsn
,	,	Z
sukladno	sukladno	Rgp
raspoloživim	raspoloživ	Agpnply
sredstvima	sredstvo	Ncnpl
u	u	Sl
Državnome	državni	Agpmsly
proračunu	proračun	Ncmsl
,	,	Z
posebnom	poseban	Agpfsiy
odlukom	odluka	Ncfsi
.	.	Z

Ministar	ministar	Ncmsn
može	moći	Vmr3s
odrediti	odrediti	Vmn
iznos	iznos	Ncmsan
subvencije	subvencija	Ncfsg
ovisno	ovisno	Rgp
o	o	Sl
socijalno-ekonomskome	socijalno-ekonomskoma	Ncfsl
statusu	status	Ncmsl
studenata	student	Ncmpg
.	.	Z

Studenti	student	Ncmpn
imaju	imati	Vmr3p
pravo	pravo	Ncnsa
na	na	Sa
subvencionirani	subvencionirati	Agpmsayn
smještaj	smještaj	Ncmsan
od	od	Sg
1.	1.	Mdo
rujna	rujan	Ncmsg
do	do	Sg
15.	15.	Mdo
srpnja	srpanj	Ncmsg
,	,	Z
osim	osim	Sg
studenata	student	Ncmpg
iz	iz	Sg
članka	članak	Ncmsg
6.	6.	Mdo

SMJEŠTAJNI	smještajan	Agpmpny
KAPACITETI	kapacitet	Ncmpn
OBNOVLJENI	obnoviti	Appmpny
ILI	ili	Cc
IZGRAĐENI	izgraditi	Appmpny
SREDSTVIMA	sredstvo	Ncmpd
STRUKTURNIH	strukturni	Agpmpgy
FONDOVA	fond	Ncmpg
EU-a	EU	Npmsg

Članak	članak	Ncmsn
25.	25.	Mdo

Od	od	Sg
ukupnog	ukupan	Agpmsgy
broja	broj	Ncmsg
smještajnih	smještajan	Agpmpgy
kapaciteta	kapacitet	Ncmpg
obnovljenih	obnoviti	Appmpgy
ili	ili	Cc
izgrađenih	izgraditi	Appmpgy
sredstvima	sredstvo	Ncmpg
iz	iz	Sg
Strukturnih	strukturni	Agpmpgy
fondova	fond	Ncmpg
EU-a	EU	Npmsg
najmanje	malo	Rgs
50	50	Mdc
%	%	Z
mora	morati	Vmr3s
biti	biti	Van
namijenjeno	namijeniti	Appnsny
studentima	student	Ncmpd
čiji	čiji	Pi-mpn
ukupni	ukupan	Agpmsayn
mjesečni	mjesečan	Agpmsayn
prihod	prihod	Ncmsan
po	po	Sl
članu	član	Ncmsl
zajedničkog	zajednički	Agpnsgy
kućanstva	kućanstvo	Ncnsg
(	(	Z
svi	sav	Agpmpny
članovi	član	Ncmpn
koji	koji	Pi-mpn
su	biti	Var3p
prijavljeni	prijaviti	Appmpny
na	na	Sl
istoj	isti	Agpfsly
adresi	adresa	Ncfsl
)	)	Z
u	u	Sl
prethodnoj	prethodan	Agpfsly
kalendarskoj	kalendarski	Agpfsly
godini	godina	Ncfsl
iznosi	iznositi	Vmr3s
manje	malo	Rgc
ili	ili	Cc
jednako	jednako	Rgp
65	65	Mdc
%	%	Z
proračunske	proračunski	Agpfsgy
osnovice	osnovica	Ncfsg
.	.	Z

PRIJELAZNE	prijelazan	Agpfpny
I	i	Cc
ZAVRŠNE	završan	Agpfpay
ODREDBE	odredba	Ncfpa

Članak	članak	Ncmsn
26.	26.	Mdo

Ovaj	ovaj	Pd-msn
pravilnik	pravilnik	Ncmsn
stupa	stupati	Vmr3s
na	na	Sa
snagu	snaga	Ncfsa
osmoga	osmi	Mlomsg
dana	dan	Ncmsg
od	od	Sg
dana	dan	Ncmsg
objave	objava	Ncfsg
u	u	Sl
»	»	Z
Narodnim	narodni	Agpfply
novinama	novina	Ncfpl
«	«	Z
.	.	Z

Klasa	klasa	Ncfsn
:	:	Z
602	602	Mdc
-	-	Z
01/15	01/15	Mdc
-	-	Z
03/00127	03/00127	Mdc

Urbroj	urbroj	Ncmsn
:	:	Z
533	533	Mdc
-	-	Z
20	20	Mdc
-	-	Z
15	15	Mdc
-	-	Z
0001	0001	Mdc

Zagreb	Zagreb	Npmsn
,	,	Z
15.	15.	Mdo
lipnja	lipanj	Ncmsg
2015.	2015.	Mdo

Ministar	ministar	Ncmsn
prof.	prof.	Y
dr.	dr.	Y
sc.	sc.	Y
Vedran	Vedran	Npmsn
Mornar	Mornar	Npmsn
,	,	Z
v.	v.	Y
r.	r.	Y

