djelotvornog	djelotvoran	Agpnsgy
i	i	Cc
učinkovitog	učinkovit	Agpmsgy
javnog	javan	Agpmsgy
sektora	sektor	Ncmsg
koji	koji	Pi-msn
pruža	pružati	Vmr3s
kvalitetne	kvalitetan	Agpfpay
usluge	usluga	Ncfpa
svojim	svoj	Px-mpd
korisnicima	korisnik	Ncmpd
i	i	Cc
štiti	štititi	Vmr3s
ustavna	ustavan	Agpnpay
prava	pravo	Ncnpa
,	,	Z
učvršćuje	učvršćivati	Vmr3s
demokraciju	demokracija	Ncfsa
te	te	Cc
omogućuje	omogućivati	Vmr3s
napredak	napredak	Ncmsan
i	i	Cc
blagostanje	blagostanje	Ncnsa
kroz	kroz	Sa
održivi	održiv	Agpmsayn
razvoj	razvoj	Ncmsan
.	.	Z

Upravni	upravan	Agpmsny
sustav	sustav	Ncmsn
treba	trebati	Vmr3s
odražavati	odražavati	Vmn
stvarne	stvaran	Agpfpay
potrebe	potreba	Ncfpa
svojih	svoj	Px-mpg
korisnika	korisnik	Ncmpg
i	i	Cc
biti	biti	Van
sveden	svesti	Appmsnn
na	na	Sa
svoju	svoj	Px-fsa
najjednostavniju	jednostavan	Agsfsay
moguću	moguć	Agpfsay
i	i	Cc
logički	logički	Rgp
najopravdaniju	najopravdaniti	Vmr3p
strukturu	struktura	Ncfsa
,	,	Z
a	a	Cc
da	da	Cs
pritom	pritom	Rgp
uspijeva	uspijevati	Vmr3s
pravodobno	pravodobno	Rgp
i	i	Cc
učinkovito	učinkovito	Rgp
udovoljavati	udovoljavati	Vmn
zahtjevima	zahtjev	Ncmpd
korisnika	korisnik	Ncmpg
.	.	Z

Kriteriji	kriterij	Ncmpn
na	na	Sl
temelju	temelj	Ncmsl
kojih	koji	Pi-mpg
će	htjeti	Var3s
se	sebe	Px--sa
izraditi	izraditi	Vmn
optimalni	optimalan	Agpmsny
model	model	Ncmsn
upravnog	upravan	Agpmsgy
sustava	sustav	Ncmsg
trebaju	trebati	Vmr3p
proizlaziti	proizlaziti	Vmn
iz	iz	Sg
rezultata	rezultat	Ncmpg
prethodno	prethodno	Rgp
provedenih	provesti	Appfpgy
analiza	analiza	Ncfpg
procesa	proces	Ncmpg
i	i	Cc
ljudskih	ljudski	Agpmpgy
potencijala	potencijal	Ncmpg
te	te	Cc
iz	iz	Sg
potrebe	potreba	Ncfsg
osiguravanja	osiguravanje	Ncnsg
broja	broj	Ncmsg
zaposlenih	zaposlen	Agpmpgy
i	i	Cc
njihovih	njihov	Ps3fpg
kompetencija	kompetencija	Ncfpg
potrebnih	potreban	Agpfpgy
za	za	Sa
zdravo	zdrav	Agpnsay
funkcioniranje	funkcioniranje	Ncnsa
sustava	sustav	Ncmsg
.	.	Z

U	u	Sl
podlozi	podloga	Ncfsl
dosadašnjih	dosadašnji	Agpfpgy
izmjena	izmjena	Ncfpg
sustava	sustav	Ncmsg
javne	javan	Agpfsgy
uprave	uprava	Ncfsg
dolazilo	dolaziti	Vmp-sn
je	biti	Var3s
do	do	Sg
pojava	pojava	Ncfpg
poput	poput	Sg
osnivanja	osnivanje	Ncnsg
institucija	institucija	Ncfpg
radi	radi	Sg
ispunjavanja	ispunjavanje	Ncnsg
ambicija	ambicija	Ncfpg
pojedinaca	pojedinac	Ncmpg
,	,	Z
nepotrebnog	nepotreban	Agpnsgy
formiranja	formiranje	Ncnsg
ustrojstvenih	ustrojstven	Agpfpgy
jedinica	jedinica	Ncfpg
na	na	Sa
čije	čiji	Pi-nsa
su	biti	Var3p
čelo	čelo	Ncnsa
postavljani	postavljati	Appmpny
zaposlenici	zaposlenik	Ncmpn
neodgovarajućih	neodgovarajući	Agpfpgy
sposobnosti	sposobnost	Ncfpg
do	do	Sg
izmišljanja	izmišljanje	Ncnsg
realno	realno	Rgp
nepotrebnih	nepotreban	Agpmpgy
poslovnih	poslovan	Agpmpgy
procesa	proces	Ncmpg
koji	koji	Pi-mpn
bi	biti	Vaa3p
služili	služiti	Vmp-pm
kao	kao	Cs
opravdanje	opravdanje	Ncnsa
za	za	Sa
formiranje	formiranje	Ncnsa
novih	nov	Agpfpgy
institucija	institucija	Ncfpg
ili	ili	Cc
ustrojstvenih	ustrojstven	Agpfpgy
jedinica	jedinica	Ncfpg
.	.	Z

Takve	takav	Pd-fpn
intervencije	intervencija	Ncfpn
u	u	Sa
sustav	sustav	Ncmsan
za	za	Si
sobom	sebe	Px--si
su	biti	Var3p
povlačile	povlačiti	Vmp-pf
daljnje	daljnji	Agpnsay
zapošljavanje	zapošljavanje	Ncnsa
koje	koji	Pi-nsn
je	biti	Var3s
opet	opet	Rgp
trebalo	trebati	Vmp-sn
opravdavati	opravdavati	Vmn
formiranjem	formiranje	Ncnsi
novih	nov	Agpmpgy
nepotrebnih	nepotreban	Agpmpgy
procesa	proces	Ncmpg
,	,	Z
što	što	Pi3n-n
je	biti	Var3s
otvaralo	otvarati	Vmp-sn
put	put	Ncmsan
daljnjoj	daljnji	Agpfsdy
birokratizaciji	birokratizacija	Ncfsd
i	i	Cc
nepreglednosti	nepreglednost	Ncfsl
sustava	sustav	Ncmsg
.	.	Z

Zbog	zbog	Sg
svega	sav	Agpnsgy
navedenog	naveden	Agpnsgy
nije	biti	Var3s
moguće	moguć	Agpnsny
provoditi	provoditi	Vmn
sustavnu	sustavan	Agpfsay
reformu	reforma	Ncfsa
javne	javan	Agpfsgy
uprave	uprava	Ncfsg
bez	bez	Sg
prethodne	prethodan	Agpfsgy
analize	analiza	Ncfsg
poslovnih	poslovan	Agpmpgy
procesa	proces	Ncmpg
i	i	Cc
ljudskih	ljudski	Agpmpgy
potencijala	potencijal	Ncmpg
angažiranih	angažirati	Appmpgy
na	na	Sl
njihovoj	njihov	Ps3fsl
provedbi	provedba	Ncfsl
.	.	Z

Pojednostavnjivanjem	pojednostavnjivanje	Ncnsi
procesa	proces	Ncmsg
u	u	Sl
upravi	uprava	Ncfsl
,	,	Z
odnosno	odnosno	Rgp
ukidanjem	ukidanje	Ncnsi
onih	onaj	Pd-mpg
koji	koji	Pi-mpn
budu	biti	Var3p
utvrđeni	utvrditi	Appmpny
kao	kao	Cs
nepotrebni	nepotreban	Agpmpny
,	,	Z
kao	kao	Cs
i	i	Cc
određivanjem	određivanje	Ncnsi
broja	broj	Ncmsg
i	i	Cc
kompetencija	kompetencija	Ncfsn
zaposlenika	zaposlenik	Ncmpg
potrebnih	potreban	Agpmpgy
da	da	Cs
bi	biti	Vaa3p
mogli	moći	Vmp-pm
odgovarajuće	odgovarajući	Agpfpay
sudjelovati	sudjelovati	Vmn
u	u	Sl
provedbi	provedba	Ncfsl
postupaka	postupak	Ncmpg
bit	biti	Van
će	htjeti	Var3p
ostvareni	ostvariti	Appmpny
nužni	nužan	Agpmpny
preduvjeti	preduvjet	Ncmpn
za	za	Sa
formiranje	formiranje	Ncnsa
optimalnog	optimalan	Agpmsgy
sustava	sustav	Ncmsg
javne	javan	Agpfsgy
uprave	uprava	Ncfsg
.	.	Z

Izrađena	izraditi	Appfsny
stručno-analitička	stručno-analitički	Agpfsny
podloga	podloga	Ncfsn
osnova	osnova	Ncfpg
je	biti	Var3s
i	i	Qo
za	za	Sa
provođenje	provođenje	Ncnsa
racionalizacije	racionalizacija	Ncfsg
u	u	Sl
sustavu	sustav	Ncmsl
agencija	agencija	Ncfpg
,	,	Z
zavoda	zavod	Ncmpg
,	,	Z
fondova	fond	Ncmpg
,	,	Z
centara	centar	Ncmpg
i	i	Cc
drugih	drugi	Mlofpg
pravnih	pravni	Agpfpgy
osoba	osoba	Ncfpg
iz	iz	Sg
nadležnosti	nadležnost	Ncfsg
pojedinih	pojedini	Agpnpgy
ministarstava	ministarstvo	Ncnpg
,	,	Z
koja	koji	Pi-fsn
pretpostavlja	pretpostavljati	Vmr3s
provedbu	provedba	Ncfsa
odgovarajućih	odgovarajući	Agpmpgy
statusnih	statusni	Agpmpgy
(	(	Z
pripajanja	pripajanje	Ncnsg
,	,	Z
spajanja	spajanje	Ncnsg
,	,	Z
podjele	podjela	Ncfsg
i	i	Cc
ukidanja	ukidanje	Ncnsg
pravnih	pravni	Agpfpgy
osoba	osoba	Ncfpg
)	)	Z
i	i	Cc
organizacijskih	organizacijski	Agpmpgy
(	(	Z
odgovarajuća	odgovarajući	Agpfsny
izmjena	izmjena	Ncfsn
unutarnjeg	unutarnji	Agpnsgy
ustrojstva	ustrojstvo	Ncnsg
)	)	Z
promjena	promjena	Ncfpg
,	,	Z
uz	uz	Sa
osiguranje	osiguranje	Ncnsa
kontinuiteta	kontinuitet	Ncmsg
u	u	Sl
obavljanju	obavljanje	Ncnsl
poslova	posao	Ncmpg
.	.	Z

Racionalizacija	racionalizacija	Ncfsn
sustava	sustav	Ncmsg
moguća	moguć	Agpfsny
je	biti	Var3s
i	i	Qo
glede	glede	Sg
tzv.	tzv.	Y
regulatornih	regulatoran	Agpfpgy
agencija	agencija	Ncfpg
.	.	Z

Važno	važan	Agpnsny
je	biti	Var3s
napomenuti	napomenuti	Vmn
da	da	Cs
hrvatsko	hrvatski	Agpnsny
pozitivno	pozitivan	Agpnsny
pravo	pravo	Ncnsn
ne	ne	Qz
daje	davati	Vmr3s
formalnu	formalan	Agpfsay
opću	opći	Agpfsay
definiciju	definicija	Ncfsa
regulatorne	regulatoran	Agpfsgy
agencije	agencija	Ncfsg
.	.	Z

Kao	kao	Cs
bitna	bitan	Agpnpay
svojstva	svojstvo	Ncnpa
regulatornih	regulatoran	Agpfpgy
agencija	agencija	Ncfpg
ističu	isticati	Vmr3p
se	sebe	Px--sa
:	:	Z
»	»	Z
1.	1.	Mdo
pravna	pravni	Agpfsny
osoba	osoba	Ncfsn
s	sa	Si
javnim	javan	Agpfpiy
ovlastima	ovlast	Ncfpi
izvan	izvan	Sg
sustava	sustav	Ncmsg
državne	državni	Agpfsgy
uprave	uprava	Ncfsg
,	,	Z
2.	2.	Mdo
javna	javan	Agpfsny
ovlast	ovlast	Ncfsn
donošenja	donošenje	Ncnsg
podzakonskih	podzakonski	Agpmpgy
propisa	propis	Ncmpg
i	i	Cc
vođenja	vođenje	Ncnsg
pojedinačnih	pojedinačan	Agpmpgy
upravnih	upravan	Agpmpgy
postupaka	postupak	Ncmpg
,	,	Z
3.	3.	Mdo
nedopuštenost	nedopuštenost	Ncfsn
žalbe	žalba	Ncfsg
na	na	Sa
pojedinačne	pojedinačan	Agpfpay
odluke	odluka	Ncfpa
agencije	agencija	Ncfsg
,	,	Z
protiv	protiv	Sg
kojih	koji	Pi-mpg
se	sebe	Px--sa
može	moći	Vmr3s
pokrenuti	pokrenuti	Vmn
upravni	upravan	Agpmsayn
spor	spor	Ncmsan
.	.	Z
«	«	Z
.	.	Z

Regulatorne	regulatoran	Agpfpny
agencije	agencija	Ncfpn
osnivaju	osnivati	Vmr3p
se	sebe	Px--sa
posebnim	poseban	Agpmsiy
zakonom	zakon	Ncmsi
u	u	Sa
svrhu	svrha	Ncfsa
usmjeravanja	usmjeravanje	Ncnsg
i	i	Cc
nadzora	nadzor	Ncmpg
nad	nad	Si
određenim	određen	Agpnsiy
sektorskim	sektorski	Agpnsiy
tržištem	tržište	Ncnsi
.	.	Z

Sektorsko	sektorski	Agpnsny
tržište	tržište	Ncnsn
odnosi	odnositi	Vmr3s
se	sebe	Px--sa
na	na	Sa
novo	nov	Agpnsay
uspostavljeno	uspostaviti	Agpnsay
tržište	tržište	Ncnsa
operatera	operater	Ncmpg
–	–	Z
privatnopravnih	privatnopravni	Agpmpgy
ponuditelja	ponuditelj	Ncmpg
javnih	javan	Agpfpgy
usluga	usluga	Ncfpg
u	u	Sl
području	područje	Ncnsl
javnih	javan	Agpfpgy
službi	služba	Ncfpg
kojim	koji	Pi-fpd
su	biti	Var3p
donedavno	donedavno	Rgp
dominirali	dominirati	Vmp-pm
razni	razni	Agpmpny
organizacijski	organizacijski	Agpmpny
oblici	oblik	Ncmpn
velikih	velik	Agpmpgy
državnih	državni	Agpmpgy
monopola	monopol	Ncmpg
.	.	Z

Najčešće	često	Rgs
su	biti	Var3p
to	taj	Pd-nsn
mrežne	mrežni	Agpfpny
industrije	industrija	Ncfpn
(	(	Z
telekomunikacije	telekomunikacija	Ncfsg
,	,	Z
pošta	pošta	Ncfsn
,	,	Z
željeznica	željeznica	Ncfsn
,	,	Z
energetika	energetika	Ncfsn
)	)	Z
,	,	Z
ali	ali	Cc
primjenjuje	primjenjivati	Vmr3s
se	sebe	Px--sa
i	i	Qo
u	u	Sl
području	područje	Ncnsl
nadzora	nadzor	Ncmsg
financijskih	financijski	Agpnpgy
tržišta	tržište	Ncnpg
,	,	Z
financijskih	financijski	Agpfpgy
usluga	usluga	Ncfpg
te	te	Cc
pravnih	pravni	Agpfpgy
i	i	Cc
fizičkih	fizički	Agpfpgy
osoba	osoba	Ncfpg
koje	koji	Pi-fpn
te	taj	Pd-fpn
usluge	usluga	Ncfpn
pružaju	pružati	Vmr3p
.	.	Z

Regulatorne	regulatoran	Agpfsgy
agencije	agencija	Ncfsg
potrebno	potreban	Agpnsny
je	biti	Var3s
identificirati	identificirati	Vmn
i	i	Cc
ujednačiti	ujednačiti	Vmn
njihovo	njihov	Ps3nsa
uređenje	uređenje	Ncnsa
.	.	Z

S	sa	Si
obzirom	obzir	Ncmsi
na	na	Sa
činjenicu	činjenica	Ncfsa
da	da	Cs
je	biti	Var3s
osnovna	osnovan	Agpfsny
svrha	svrha	Ncfsn
regulatornih	regulatoran	Agpfpgy
agencija	agencija	Ncfpg
usmjeravanje	usmjeravanje	Ncnsa
i	i	Cc
nadzor	nadzor	Ncmsan
tržišta	tržište	Ncnsg
,	,	Z
moguće	moguć	Agpnsny
je	biti	Var3s
razmotriti	razmotriti	Vmn
racionalizaciju	racionalizacija	Ncfsa
njihova	njihov	Ps3msg
broja	broj	Ncmsg
spajanjem	spajanje	Ncnsi
.	.	Z

Svrha	svrha	Ncfsn
provedbe	provedba	Ncfsg
mjera	mjera	Ncfsn
racionalizacije	racionalizacija	Ncfsg
je	biti	Var3s
u	u	Sl
pronalaženju	pronalaženje	Ncnsl
organizacijskog	organizacijski	Agpmsgy
oblika	oblik	Ncmsg
u	u	Sl
okviru	okvir	Ncmsl
kojeg	koji	Pi-msg
će	htjeti	Var3p
se	sebe	Px--sa
poslovi	posao	Ncmpn
moći	moći	Vmn
obavljati	obavljati	Vmn
na	na	Sl
učinkovitiji	učinkovit	Ncfsl
,	,	Z
svrhovitiji	svrhovit	Agcmsny
ili	ili	Cc
ekonomičniji	ekonomičan	Agcmsayn
način	način	Ncmsan
,	,	Z
uzimajući	uzimati	Rr
pritom	pritom	Rgp
u	u	Sa
obzir	obzir	Ncmsan
obveze	obveza	Ncfsg
preuzete	preuzet	Agpfsgy
prilikom	prilikom	Sg
pristupanja	pristupanje	Ncnsg
EU-u	EU	Npmsd
i	i	Cc
obveze	obveza	Ncfpn
preuzete	preuzeti	Appfpny
međunarodnim	međunarodni	Agpmpiy
sporazumima	sporazum	Ncmpi
.	.	Z

Kritički	kritički	Agpmsny
pristup	pristup	Ncmsn
postojećem	postojeći	Agpmsly
upravnom	upravan	Agpmsly
sustavu	sustav	Ncmsl
temelj	temelj	Ncmsn
je	biti	Var3s
i	i	Qo
prvi	prvi	Mlomsan
korak	korak	Ncmsan
prema	prema	Sl
njegovu	njegov	Ps3nsl
sređivanju	sređivanje	Ncnsl
i	i	Cc
racionalizaciji	racionalizacija	Ncfsl
.	.	Z

Na	na	Sl
zaključcima	zaključak	Ncmpl
proizašlima	proizašao	Agpmply
iz	iz	Sg
provedene	provesti	Agpfsgy
analize	analiza	Ncfsg
procesa	proces	Ncmsg
u	u	Sl
upravi	uprava	Ncfsl
i	i	Cc
ljudskih	ljudski	Agpmpgy
potencijala	potencijal	Ncmpg
zaposlenih	zaposlen	Agpfpgy
treba	trebati	Vmr3s
početi	početi	Vmn
razmatrati	razmatrati	Vmn

