postizanja	postizanje	Ncnsg
zadovoljstva	zadovoljstvo	Ncnsg
korisnika	korisnik	Ncmpg
.	.	Z

Također	također	Rgp
,	,	Z
središnja	središnji	Agpnpny
tijela	tijelo	Ncnpn
državne	državni	Agpfsgy
uprave	uprava	Ncfsg
u	u	Sl
čijem	čiji	Pi-msl
su	biti	Var3p
djelokrugu	djelokrug	Ncmsl
pojedina	pojedini	Agpnpny
upravna	upravan	Agpnpny
područja	područje	Ncnpn
nisu	biti	Var3p
u	u	Sl
dovoljnoj	dovoljan	Agpfsly
mjeri	mjera	Ncfsl
uključena	uključiti	Appfsny
u	u	Sa
zajedničke	zajednički	Agpfpay
aktivnosti	aktivnost	Ncfpa
i	i	Cc
koordinirano	koordinirati	Agpnsny
postizanje	postizanje	Ncnsn
zajedničkog	zajednički	Agpmsgy
cilja	cilj	Ncmsg
–	–	Z
dostizanje	dostizanje	Ncnsa
viših	visok	Agcmpgy
standarda	standard	Ncmpg
upravnoga	upravan	Agpnsgy
odlučivanja	odlučivanje	Ncnsg
.	.	Z

Isto	isto	Rgp
tako	tako	Rgp
,	,	Z
ova	ovaj	Pd-npn
tijela	tijelo	Ncnpn
ne	ne	Qz
provode	provoditi	Vmr3p
u	u	Sl
dovoljnoj	dovoljan	Agpfsly
mjeri	mjera	Ncfsl
upravni	upravan	Agpmsny
nadzor	nadzor	Ncmsn
niti	niti	Cc
analiziraju	analizirati	Vmr3p
stanje	stanje	Ncnsa
upravnoga	upravan	Agpnsgy
odlučivanja	odlučivanje	Ncnsg
u	u	Sl
svom	svoj	Px-msl
području	područje	Ncnsl
,	,	Z
zbog	zbog	Sg
čega	što	Pi3n-g
nisu	biti	Var3p
uspostavljeni	uspostaviti	Appmpny
jedinstveni	jedinstven	Agpmpny
postupovni	postupovni	Agpmpny
standardi	standard	Ncmpn
.	.	Z

S	sa	Sg
druge	drugi	Mlofsg
strane	strana	Ncfsg
,	,	Z
nedovoljna	nedovoljan	Agpfsny
pozornost	pozornost	Ncfsn
posvećuje	posvećivati	Vmr3s
se	sebe	Px--sa
jačanju	jačanje	Ncnsd
stručno-kreativnih	stručno-kreativan	Agpmpgy
poslova	posao	Ncmpg
i	i	Cc
povećanju	povećanje	Ncnsl
njihova	njihov	Ps3msg
udjela	udjel	Ncmsg
u	u	Sl
ukupnom	ukupan	Agpnsly
poslovanju	poslovanje	Ncnsl
resornih	resorni	Agpnpgy
tijela	tijelo	Ncnpg
,	,	Z
dok	dok	Cs
udio	udjel	Ncmsn
horizontalnih	horizontalan	Agpmpgy
(	(	Z
popratnih	popratni	Agpfpgy
)	)	Z
funkcija	funkcija	Ncfsn
u	u	Sl
tijelima	tijelo	Ncnpl
raste	rasti	Vmr3s
,	,	Z
unatoč	unatoč	Sd
informatičkim	informatički	Agpmsiy
i	i	Cc
sustavnim	sustavan	Agpnply
rješenjima	rješenje	Ncnpl
koja	koji	Pi-fsn
bi	biti	Vaa3s
trebala	trebati	Vmp-sf
omogućiti	omogućiti	Vmn
pojednostavnjenje	pojednostavnjenje	Ncnsa
tih	taj	Pd-fpg
funkcija	funkcija	Ncfpg
i	i	Cc
smanjenje	smanjenje	Ncnsa
resursa	resurs	Ncmpg
angažiranih	angažirati	Appmpgy
na	na	Sl
tim	taj	Pd-mpl
poslovima	posao	Ncmpl
.	.	Z

Radi	radi	Sg
omogućavanja	omogućavanje	Ncnsg
komunikacije	komunikacija	Ncfsg
stranaka	stranka	Ncfpg
s	sa	Si
javnopravnim	javnopravni	Agpnpiy
tijelima	tijelo	Ncnpi
na	na	Sa
jednostavniji	jednostavan	Agcmsayn
način	način	Ncmsan
i	i	Cc
na	na	Sl
mjestima	mjesto	Ncnpl
koja	koji	Pi-npn
su	biti	Var3p
im	oni	Pp3-pd
najbliža	blizak	Agsfsny
,	,	Z
planirano	planirati	Appnsny
je	biti	Var3s
kontinuirano	kontinuiran	Agpnsny
uspostavljanje	uspostavljanje	Ncnsn
jedinstvenih	jedinstven	Agpnpgy
upravnih	upravan	Agpnpgy
mjesta	mjesto	Ncnpg
,	,	Z
i	i	Cc
u	u	Sl
realnom	realan	Agpmsly
i	i	Cc
u	u	Sl
virtualnom	virtualan	Agpmsly
svijetu	svijet	Ncmsl
,	,	Z
čime	što	Pi3n-i
će	htjeti	Var3s
se	sebe	Px--sa
stranki	stranka	Ncfsl
omogućiti	omogućiti	Vmn
da	da	Cs
s	sa	Sg
jednog	jedan	Agpnsgy
mjesta	mjesto	Ncnsg
komunicira	komunicirati	Vmr3s
s	sa	Si
javnopravnim	javnopravni	Agpnpiy
tijelima	tijelo	Ncnpi
brže	brzo	Rgc
i	i	Cc
jednostavnije	jednostavno	Rgc
.	.	Z

Temeljne	temeljan	Agpfpay
pretpostavke	pretpostavka	Ncfpa
za	za	Sa
ustrojavanje	ustrojavanje	Ncnsa
jedinstvenih	jedinstven	Agpnpgy
upravnih	upravan	Agpnpgy
mjesta	mjesto	Ncnpg
su	biti	Var3p
informatička	informatički	Agpfsny
povezanost	povezanost	Ncfsn
javnopravnih	javnopravni	Agpnpgy
tijela	tijelo	Ncnpg
i	i	Cc
dostupnost	dostupnost	Ncfsn
središnjih	središnji	Agpmpgy
registara	registar	Ncmpg
te	te	Cc
priprema	pripremati	Vmr3s
aplikacija	aplikacija	Ncfsn
na	na	Sl
temelju	temelj	Ncmsl
pojednostavnjenih	pojednostavniti	Agpmpgy
procesa	proces	Ncmpg
,	,	Z
što	što	Pi3n-n
zahtijeva	zahtijevati	Vmr3s
dobru	dobar	Agpfsay
unutarnju	unutarnji	Agpfsay
povezanost	povezanost	Ncfsa
i	i	Cc
koordinaciju	koordinacija	Ncfsa
javnopravnih	javnopravni	Agpnpgy
tijela	tijelo	Ncnpg
.	.	Z

Digitalizacija	digitalizacija	Ncfsn
dokumenata	dokument	Ncmpg
zaprimljenih	zaprimiti	Appmpgy
na	na	Sl
papiru	papir	Ncmsl
,	,	Z
kao	kao	Cs
i	i	Cc
digitalizacija	digitalizacija	Ncfsn
procesa	proces	Ncmsg
upravljanja	upravljanje	Ncnsg
pismenima	pismena	Ncnpi
osnovni	osnovan	Agpmpny
su	biti	Var3p
procesi	proces	Ncmpn
koji	koji	Pi-mpn
za	za	Sa
jedinstveno	jedinstven	Agpnsay
upravno	upravan	Agpnsay
mjesto	mjesto	Ncnsa
u	u	Sl
realnom	realan	Agpmsly
svijetu	svijet	Ncmsl
moraju	morati	Vmr3p
biti	biti	Van
informatizirani	informatizirati	Appmpny
.	.	Z

Za	za	Sa
kvalitetno	kvalitetan	Agpnsay
pružanje	pružanje	Ncnsa
usluga	usluga	Ncfpg
ključno	ključan	Agpnsny
je	biti	Var3s
pružiti	pružiti	Vmn
korisnicima	korisnik	Ncmpd
kvalitetne	kvalitetan	Agpfsgy
informacije	informacija	Ncfsg
na	na	Sa
standardiziran	standardiziran	Agpmsann
i	i	Cc
strukturiran	strukturiran	Agpmsann
način	način	Ncmsan
kako	kako	Cs
bi	biti	Vaa3p
znali	znati	Vmp-pm
kako	kako	Cs
zatražiti	zatražiti	Vmn
usluge	usluga	Ncfpa
ovisno	ovisno	Rgp
o	o	Sl
tome	taj	Pd-nsl
kojim	koji	Pi-msi
komunikacijskim	komunikacijski	Agpmsiy
kanalom	kanal	Ncmsi
pristupaju	pristupati	Vmr3p
.	.	Z

Pružanje	pružanje	Ncnsn
pravodobnih	pravodoban	Agpmpgy
,	,	Z
standardiziranih	standardiziran	Agpmpgy
i	i	Cc
kvalitetnih	kvalitetan	Agpfpgy
usluga	usluga	Ncfpg
treba	trebati	Vmr3s
biti	biti	Van
temeljni	temeljan	Agpmsny
zadatak	zadatak	Ncmsn
svakog	svaki	Pi-nsg
javnopravnog	javnopravni	Agpnsgy
tijela	tijelo	Ncnsg
.	.	Z

Te	taj	Pd-fpn
usluge	usluga	Ncfpn
moraju	morati	Vmr3p
biti	biti	Van
usklađene	uskladiti	Appfpny
sa	sa	Si
stvarnim	stvaran	Agpfpiy
potrebama	potreba	Ncfpi
korisnika	korisnik	Ncmpg
i	i	Cc
ne	ne	Qz
smiju	smjeti	Vmr3p
predstavljati	predstavljati	Vmn
nepotrebnu	nepotreban	Agpfsay
birokratizaciju	birokratizacija	Ncfsa
koja	koji	Pi-fsn
opterećuje	opterećivati	Vmr3s
financijske	financijski	Agpmpay
i	i	Cc
ljudske	ljudski	Agpmpay
upravne	upravan	Agpmpay
kapacitete	kapacitet	Ncmpa
bez	bez	Sg
dodane	dodati	Agpfsgy
vrijednosti	vrijednost	Ncfsg
i	i	Cc
time	taj	Pd-nsi
opravdano	opravdati	Appnsny
proizvodi	proizvoditi	Vmr3s
negativne	negativan	Agpfpay
reakcije	reakcija	Ncfpa
korisnika	korisnik	Ncmpg
.	.	Z

Definiranjem	definiranje	Ncnsi
usluga	usluga	Ncfpg
za	za	Si
kojima	koji	Pi-mpi
postoji	postojati	Vmr3s
stvarna	stvaran	Agpfsny
potreba	potreba	Ncfsn
i	i	Cc
njihovim	njihov	Ps3nsi
pažljivim	pažljiv	Agpnsiy
usklađivanjem	usklađivanje	Ncnsi
s	sa	Si
novim	nov	Agpfpiy
potrebama	potreba	Ncfpi
,	,	Z
uz	uz	Sa
aktivno	aktivan	Agpnsay
sudjelovanje	sudjelovanje	Ncnsa
javnosti	javnost	Ncfsg
kao	kao	Cs
partnera	partner	Ncmsg
,	,	Z
zatvorio	zatvoriti	Vmp-sm
bi	biti	Vaa3s
se	sebe	Px--sa
prostor	prostor	Ncmsn
utvrđivanju	utvrđivanje	Ncnsd
dodatnih	dodatan	Agpfpgy
obveza	obveza	Ncfpg
za	za	Sa
korisnike	korisnik	Ncmpa
u	u	Sl
ostvarivanju	ostvarivanje	Ncnsl
njihovih	njihov	Ps3npg
prava	pravo	Ncnpg
i	i	Cc
pravnih	pravni	Agpmpgy
interesa	interes	Ncmpg
,	,	Z
kao	kao	Cs
i	i	Cc
povećavanju	povećavanje	Ncnsl
javne	javan	Agpfsgy
uprave	uprava	Ncfsg
osnivanjem	osnivanje	Ncnsi
novih	nov	Agpnpgy
tijela	tijelo	Ncnpg
i	i	Cc
pravnih	pravni	Agpfpgy
osoba	osoba	Ncfpg
čije	čiji	Pi-fpn
poslove	posao	Ncmpa
mogu	moći	Vmr3p
obavljati	obavljati	Vmn
već	već	Rgp
postojeća	postojeći	Agpnpay
tijela	tijelo	Ncnpa
i	i	Cc
pravne	pravni	Agpfsgy
osobe	osoba	Ncfsg
s	sa	Si
postojećim	postojeći	Agpmpiy
resursima	resurs	Ncmpi
.	.	Z

Time	taj	Pd-nsi
će	htjeti	Var3s
se	sebe	Px--sa
smanjiti	smanjiti	Vmn
opterećenje	opterećenje	Ncnsa
za	za	Sa
državni	državni	Agpmsayn
proračun	proračun	Ncmsan
,	,	Z
a	a	Cc
konačno	konačno	Rgp
i	i	Qo
za	za	Sa
sve	sav	Agpmpay
korisnike	korisnik	Ncmpa
usluga	usluga	Ncfpg
.	.	Z

4.1.6.	4.1.6.	Mdo

Upravno	upravan	Agpnsny
postupanje	postupanje	Ncnsn
i	i	Cc
odlučivanje	odlučivanje	Ncnsa

U	u	Sl
tijeku	tijek	Ncmsl
pregovora	pregovor	Ncmpg
za	za	Sa
pristupanje	pristupanje	Ncnsa
Republike	republika	Ncfsg
Hrvatske	Hrvatska	Npfsg
EU-u	EU	Npmsd
donesen	donijeti	Appmsnn
je	biti	Var3s
ZUP	ZUP	Npmsn
,	,	Z
koji	koji	Pi-msn
je	biti	Var3s
stupio	stupiti	Vmp-sm
na	na	Sa
snagu	snaga	Ncfsa
1.	1.	Mdo
siječnja	siječanj	Ncmsg
2010.	2010.	Mdo

Jedna	jedan	Mlcfsn
od	od	Sg
temeljnih	temeljan	Agpfpgy
postavki	postavka	Ncfpg
ZUP-a	ZUP	Npmsg
njegova	njegov	Ps3fsn
je	biti	Var3s
primjena	primjena	Ncfsn
u	u	Sl
postupanju	postupanje	Ncnsl
u	u	Sl
svim	sav	Agpfply
upravnim	upravan	Agpfply
stvarima	stvar	Ncfpl
,	,	Z
što	što	Pi3n-n
znači	značiti	Vmr3s
da	da	Cs
on	on	Pp3msn
više	mnogo	Rgc
nije	biti	Var3s
supsidijarni	supsidijaran	Agpmsny
propis	propis	Ncmsn
te	te	Cc
da	da	Cs
je	biti	Var3s
odredbe	odredba	Ncfpa
posebnih	poseban	Agpmpgy
zakona	zakon	Ncmpg
potrebno	potreban	Agpnsny
uskladiti	uskladiti	Vmn
sa	sa	Si
ZUP-om	ZUP	Npmsi
.	.	Z

Stoga	stoga	Rgp
je	biti	Var3s
,	,	Z
u	u	Sl
okviru	okvir	Ncmsl
programa	program	Ncmsg
bilateralne	bilateralan	Agpfsgy
pomoći	pomoć	Ncfsg
Ministarstva	ministarstvo	Ncnsg
vanjskih	vanjski	Agpmpgy
poslova	posao	Ncmpg
Kraljevine	kraljevina	Ncfsg
Danske	Danska	Npfsg
»	»	Z
Potpora	potpora	Ncfsn
razvoju	razvoj	Ncmsl
kapaciteta	kapacitet	Ncmsg
javnog	javan	Agpmsgy
sektora	sektor	Ncmsg
«	«	Z
,	,	Z
realiziran	realizirati	Appmsnn
projekt	projekt	Ncmsn
»	»	Z
Pripreme	priprema	Ncfpn
za	za	Sa
implementaciju	implementacija	Ncfsa
novog	nov	Agpmsgy
Zakona	zakon	Ncmsg
o	o	Sl
općem	opći	Agpmsly
upravnom	upravan	Agpmsly
postupku	postupak	Ncmsl
«	«	Z
,	,	Z
izrađena	izraditi	Appfsny
analiza	analiza	Ncfsn
postojećih	postojeći	Agpmpgy
posebnih	poseban	Agpmpgy
propisa	propis	Ncmpg
i	i	Cc
kategorizacija	kategorizacija	Ncfpg
odstupanja	odstupanje	Ncnsg
od	od	Sg
odredbi	odredba	Ncfpg
ZUP-a	ZUP	Npmsg
za	za	Sa
118	118	Mdc
zakona	zakon	Ncmpg
te	te	Cc
izvršeno	izvršiti	Appnsny
njihovo	njihov	Ps3nsn
usklađivanje	usklađivanje	Ncnsn
sa	sa	Si
ZUP-om	ZUP	Npmsi
.	.	Z

Nakon	nakon	Sg
završetka	završetak	Ncmsg
tog	taj	Pd-msg
Projekta	projekt	Ncmsg
nastavljeno	nastaviti	Appnsny
je	biti	Var3s
,	,	Z
kao	kao	Cs
kontinuirana	kontinuiran	Agpfsny
zadaća	zadaća	Ncfsn
,	,	Z
praćenje	praćenje	Ncnsn
usklađenosti	usklađenost	Ncfsg
zakonskih	zakonski	Agpmpgy
prijedloga	prijedlog	Ncmpg
sa	sa	Si
ZUP-om	ZUP	Npmsi
u	u	Sl
postupku	postupak	Ncmsl
donošenja	donošenje	Ncnsg
zakona	zakon	Ncmsg
.	.	Z

Svrha	svrha	Ncfsn
tog	taj	Pd-nsg
usklađivanja	usklađivanje	Ncnsg
je	biti	Var3s
smanjenje	smanjenje	Ncnsn
broja	broj	Ncmsg
posebnih	poseban	Agpmpgy
upravnih	upravan	Agpmpgy
postupaka	postupak	Ncmpg
u	u	Sa
korist	korist	Ncfsa
ZUP-a	ZUP	Npmsg
kao	kao	Cs
općeg	opći	Agpmsgy
zakona	zakon	Ncmsg
koje	koji	Pi-nsa
treba	trebati	Vmr3s
osigurati	osigurati	Vmn
predvidljivost	predvidljivost	Ncfsa
i	i	Cc
ujednačavanje	ujednačavanje	Ncnsa
upravnog	upravan	Agpnsgy
postupanja	postupanje	Ncnsg
i	i	Cc
veću	velik	Agcfsay
pravnu	pravni	Agpfsay
sigurnost	sigurnost	Ncfsa
građana	građanin	Ncmpg
.	.	Z

Najčešća	čest	Agsfsny
odstupanja	odstupanje	Ncnsg
posebnih	poseban	Agpmpgy
zakona	zakon	Ncmpg
od	od	Sg
ZUP-a	ZUP	Npmsg
odnose	odnositi	Vmr3p
se	sebe	Px--sa
na	na	Sa
:	:	Z

−		Agcnsay
propisivanje	propisivanje	Ncnsa
drugostupanjskih	drugostupanjski	Agpnpgy
tijela	tijelo	Ncnpg
koja	koji	Pi-npn
nisu	biti	Var3p
predviđena	predvidjeti	Appnpny
ZUP-om	ZUP-om	Pi3n-n
(	(	Z
najčešće	često	Rgs
različitih	različit	Agpfpgy

