politike	politika	Ncfpa
s	sa	Si
ciljevima	cilj	Ncmpi
i	i	Cc
odredbama	odredba	Ncfpi
definiranim	definirati	Appfply
na	na	Sl
razini	razina	Ncfsl
EU-a	EU	Npmsg
,	,	Z
a	a	Cc
na	na	Sl
sjednici	sjednica	Ncfsl
23.	23.	Mdo
travnja	travanj	Ncmsg
2015.	2015.	Mdo
prihvatila	prihvatiti	Vmp-sf
je	biti	Var3s
svoj	svoj	Px-msan
drugi	drugi	Mlomsn
Nacionalni	nacionalan	Agpmsny
program	program	Ncmsn
reformi	reforma	Ncfpg
kojim	koji	Pi-msi
su	biti	Var3p
usvojena	usvojiti	Appnpny
tri	tri	Mlc
paketa	paket	Ncmsg
mjera	mjera	Ncfpg
:	:	Z
mjere	mjera	Ncfpn
za	za	Sa
promicanje	promicanje	Ncnsa
rasta	rast	Ncmsg
,	,	Z
vanjske	vanjski	Agpfsgy
konkurentnosti	konkurentnost	Ncfsg
i	i	Cc
ponovnu	ponovan	Agpfsay
uspostavu	uspostava	Ncfsa
ravnoteža	ravnoteža	Ncfpg
u	u	Sl
gospodarstvu	gospodarstvo	Ncnsl
,	,	Z
mjere	mjera	Ncfpn
za	za	Sa
rješavanje	rješavanje	Ncnsa
slabosti	slabost	Ncfsg
u	u	Sl
upravljanju	upravljanje	Ncnsl
i	i	Cc
podizanje	podizanje	Ncnsa
učinkovitosti	učinkovitost	Ncfsg
javnog	javan	Agpmsayn
sektor	sektor	Ncmsan
i	i	Cc
mjere	mjera	Ncfpn
za	za	Sa
povećanje	povećanje	Ncnsa
održivosti	održivost	Ncfsg
duga	dug	Ncmsg
opće	opći	Agpfsgy
države	država	Ncfsg
i	i	Cc
jačanje	jačanje	Ncnsa
upravljanja	upravljanje	Ncnsg
javnim	javan	Agpfpiy
financijama	financije	Ncfpi
.	.	Z

Drugi	drugi	Mlomsn
Nacionalni	nacionalan	Agpmsny
plan	plan	Ncmsn
reformi	reforma	Ncfpg
sadržava	sadržavati	Vmr3s
mjere	mjera	Ncfpa
koje	koji	Pi-fpn
odgovaraju	odgovarati	Vmr3p
mjerama	mjera	Ncfpi
predviđenim	predvidjeti	Agpfpiy
u	u	Sl
Strategiji	strategija	Ncfsl
.	.	Z

Na	na	Sl
temelju	temelj	Ncmsl
Zakona	zakon	Ncmsg
o	o	Sl
proračunu	proračun	Ncmsl
Vlada	vlada	Ncfsn
Republike	republika	Ncfsg
Hrvatske	Hrvatska	Npfsg
je	biti	Var3s
svake	svaki	Pi-fsg
godine	godina	Ncfsg
donosila	donositi	Vmp-sf
strategiju	strategija	Ncfsa
Vladinih	vladin	Agpmpgy
programa	program	Ncmpg
za	za	Sa
trogodišnje	trogodišnji	Agpnsay
razdoblje	razdoblje	Ncnsa
.	.	Z

Na	na	Sa
sadržaj	sadržaj	Ncmsan
zadnje	zadnji	Agpfsgy
Strategije	strategija	Ncfsg
Vladinih	vladin	Agpmpgy
programa	program	Ncmpg
za	za	Sa
razdoblje	razdoblje	Ncnsa
2015.	2015.	Mdo
–	–	Z
2017.	2017.	Mdo
,	,	Z
koju	koji	Pi-fsa
je	biti	Var3s
Vlada	vlada	Ncfsn
Republike	republika	Ncfsg
Hrvatske	Hrvatska	Npfsg
donijela	donijeti	Vmp-sf
7.	7.	Mdo
studenoga	studeni	Ncmsg
2014.	2014.	Mdo
,	,	Z
bitno	bitno	Rgp
su	biti	Var3p
utjecala	utjecati	Vmp-pn
dva	dva	Mlc
ključna	ključan	Agpmsgn
dokumenta	dokument	Ncmsg
Europskog	europski	Agpmsgy
semestra	semestar	Ncmsg
–	–	Z
Nacionalni	nacionalan	Agpmsny
program	program	Ncmsn
reformi	reforma	Ncfpg
i	i	Cc
Program	program	Ncmsn
konvergencije	konvergencija	Ncfsg
Republike	republika	Ncfsg
Hrvatske	Hrvatska	Npfsg
.	.	Z

Program	program	Ncmsn
konvergencije	konvergencija	Ncfsg
definira	definirati	Vmr3s
makroekonomski	makroekonomski	Agpmsayn
i	i	Cc
fiskalni	fiskalan	Agpmsny
okvir	okvir	Ncmsn
države	država	Ncfsg
članice	članica	Ncfsg
u	u	Sl
tekućoj	tekući	Agpfsly
godini	godina	Ncfsl
i	i	Cc
nastupajućem	nastupajući	Agpnsly
trogodišnjem	trogodišnji	Agpnsly
razdoblju	razdoblje	Ncnsl
.	.	Z

Zakonom	zakon	Ncmsi
o	o	Sl
izmjenama	izmjena	Ncfpl
i	i	Cc
dopunama	dopuna	Ncfpl
Zakona	zakon	Ncmsg
o	o	Sl
proračunu	proračun	Ncmsl
[	[	Z
3	3	Mdc
]	]	Z
proračunski	proračunski	Agpmsny
proces	proces	Ncmsn
Republike	republika	Ncfsg
Hrvatske	Hrvatska	Npfsg
usklađen	uskladiti	Appmsnn
je	biti	Var3s
s	sa	Si
Europskim	europski	Agpmsiy
semestrom	semestar	Ncmsi
s	sa	Si
obzirom	obzir	Ncmsi
na	na	Sa
to	taj	Pd-nsa
da	da	Cs
je	biti	Var3s
Republika	republika	Ncfsn
Hrvatska	Hrvatska	Npfsn
,	,	Z
kao	kao	Cs
država	država	Ncfsn
članica	članica	Ncfpg
EU-a	EU	Npmsg
,	,	Z
dužna	dužan	Agpfsny
na	na	Sl
godišnjoj	godišnji	Agpfsly
razini	razina	Ncfsl
donositi	donositi	Vmn
dva	dva	Mlc
ključna	ključan	Agpmsgn
dokumenta	dokument	Ncmsg
–	–	Z
program	program	Ncmsan
konvergencije	konvergencija	Ncfsg
i	i	Cc
nacionalni	nacionalan	Agpmsny
program	program	Ncmsn
reformi	reforma	Ncfpg
.	.	Z

Stoga	stoga	Rgp
će	htjeti	Var3s
ubuduće	ubuduće	Rgp
strateški	strateški	Agpmpny
planovi	plan	Ncmpn
obveznika	obveznik	Ncmpg
biti	biti	Van
osnova	osnova	Ncfsn
za	za	Sa
izradu	izrada	Ncfsa
nacionalnog	nacionalan	Agpmsgy
programa	program	Ncmsg
reformi	reforma	Ncfpg
i	i	Cc
programa	program	Ncmsg
konvergencije	konvergencija	Ncfsg
.	.	Z

Zahvaljujući	zahvaljivati	Rr
iskustvima	iskustvo	Ncnpl
iz	iz	Sg
prethodnih	prethodan	Agpnpgy
reformskih	reformski	Agpnpgy
razdoblja	razdoblje	Ncnpg
,	,	Z
tijekom	tijekom	Sg
provedbe	provedba	Ncfsg
Strategije	strategija	Ncfsg
reforme	reforma	Ncfsg
državne	državni	Agpfsgy
uprave	uprava	Ncfsg
za	za	Sa
razdoblje	razdoblje	Ncnsa
2008.	2008.	Mdo
–	–	Z
2011.	2011.	Mdo
tako	tako	Rgp
i	i	Qo
protekle	protekao	Agpfsgy
dvije	dva	Mlcf-n
godine	godina	Ncfsg
fokusa	fokus	Ncmsg
na	na	Sa
specifične	specifičan	Agpmpay
reformske	reformski	Agpmpay
zadatke	zadatak	Ncmpa
(	(	Z
razvoj	razvoj	Ncmsan
ljudskih	ljudski	Agpmpgy
potencijala	potencijal	Ncmpg
,	,	Z
projekt	projekt	Ncmsn
e-Hrvatska	e-Hrvatsk	Npmsg
itd.	itd.	Y
)	)	Z
prepoznati	prepoznat	Agpmpny
su	biti	Var3p
rizici	rizik	Ncmpn
za	za	Sa
djelotvornost	djelotvornost	Ncfsa
i	i	Cc
učinkovitost	učinkovitost	Ncfsa
provedbe	provedba	Ncfsg
ove	ovaj	Pd-fsg
Strategije	strategija	Ncfsg
koji	koji	Pi-mpn
se	sebe	Px--sa
odnose	odnositi	Vmr3p
na	na	Sa
interno	interni	Agpnsay
upravljanje	upravljanje	Ncnsa
:	:	Z

−	−	Z
nedovoljno	nedovoljno	Rgp
kvalitetna	kvalitetan	Agpfsny
komunikacija	komunikacija	Ncfsn
između	između	Sg
izvršne	izvršan	Agpfsgy
i	i	Cc
političke	politički	Agpfsgy
razine	razina	Ncfsg

−	−	Z
nerazrađena	nerazrađen	Agpfsny
komunikacija	komunikacija	Ncfsn
između	između	Sg
nositelja	nositelj	Ncmpg
i	i	Cc
korisnika	korisnik	Ncmpg
pojedinih	pojedini	Agpfpgy
skupina	skupina	Ncfpg
mjera	mjera	Ncfpg

−	−	Pd-fsg
manjkavosti	manjkavost	Ncfsg
kontrole	kontrola	Ncfsg
nad	nad	Si
provedbom	provedba	Ncfsi
i	i	Cc
učincima	učinak	Ncmpl
na	na	Sl
središnjoj	središnji	Agpfsly
točki	točka	Ncfsl
Vlade	vlada	Ncfsg
Republike	republika	Ncfsg
Hrvatske	Hrvatska	Npfsg
,	,	Z
posebno	posebno	Rgp
glede	glede	Sg
sprječavanja	sprječavanje	Ncnsg
kašnjenja	kašnjenje	Ncnsg
i	i	Cc
neusklađenosti	neusklađenost	Ncfsg
s	sa	Si
financijskim	financijski	Agpnsiy
planiranjem	planiranje	Ncnsi

−	−	Z
izostanak	izostanak	Ncmsn
operacionalizacije	operacionalizacija	Ncfsg
i	i	Cc
specifikacije	specifikacija	Ncfpa
provedbenih	provedbeni	Agpnpgy
sredstava	sredstvo	Ncnpg

−	−	Sa
nedjelotvoran	nedjelotvoran	Agpmsann
sustav	sustav	Ncmsan
praćenja	praćenje	Ncnsg
provedbe	provedba	Ncfsg
(	(	Z
bez	bez	Sg
definiranih	definirati	Agpmpgy
pokazatelja	pokazatelj	Ncmpg
koji	koji	Pi-mpn
usmjeravaju	usmjeravati	Vmr3p
provedbu	provedba	Ncfsa
)	)	Z
i	i	Cc
izostanak	izostanak	Ncmsn
evaluacije	evaluacija	Ncfsg
rezultata	rezultat	Ncmpg
i	i	Cc
učinaka	učinak	Ncmpg

−	−	Agpmsny
izostanak	izostanak	Ncmsn
parlamentarnog	parlamentaran	Agpmsgy
nadzora	nadzor	Ncmsg
nad	nad	Si
provedbom	provedba	Ncfsi
.	.	Z

Predloženi	predložen	Agpmpny
mehanizmi	mehanizam	Ncmpn
provedbe	provedba	Ncfsg
u	u	Sl
Strategiji	strategija	Ncfsl
trebali	trebati	Vmp-pm
bi	biti	Vaa3p
otkloniti	otkloniti	Vmn
navedene	naveden	Agpmpay
rizike	rizik	Ncmpa
i	i	Cc
omogućiti	omogućiti	Vmn
njezinu	njezin	Ps3fsa
uspješnu	uspješan	Agpfsay
provedbu	provedba	Ncfsa
.	.	Z

4.	4.	Mdo
PRUŽANJE	pružanje	Ncnsn
JAVNIH	javan	Agpfpgy
USLUGA	usluga	Ncfpg

4.1.	4.1.	Mdo

Analiza	analiza	Ncfsn
stanja	stanje	Ncnsg

Analize	analiza	Ncfpn
pokazuju	pokazivati	Vmr3p
da	da	Cs
se	sebe	Px--sa
većina	većina	Ncfsn
prigovora	prigovor	Ncmpg
domaće	domaći	Agpfsgy
i	i	Cc
strane	strana	Ncfsg
javnosti	javnost	Ncfsg
odnosi	odnositi	Vmr3s
na	na	Sa
postupanja	postupanje	Ncnpa
u	u	Sl
javnoj	javan	Agpfsly
upravi	uprava	Ncfsl
koja	koji	Pi-fsn
traju	trajati	Vmr3p
predugo	predug	Agpnsay
te	te	Cc
su	biti	Var3p
često	često	Rgp
nepotrebno	nepotrebno	Rgp
složena	složiti	Appfsny
,	,	Z
na	na	Sa
nejasne	nejasan	Agpfpay
nadležnosti	nadležnost	Ncfpa
različitih	različit	Agpfpgy
institucija	institucija	Ncfpg
za	za	Sa
pojedina	pojedini	Agpnpay
pitanja	pitanje	Ncnpa
,	,	Z
na	na	Sa
lokaciju	lokacija	Ncfsa
tijela	tijelo	Ncnsg
koja	koji	Pi-npn
rješavaju	rješavati	Vmr3p
o	o	Sl
pojedinim	pojedini	Agpnply
pitanjima	pitanje	Ncnpl
te	te	Cc
na	na	Sa
radno	radni	Agpnsay
vrijeme	vrijeme	Ncnsa
institucija	institucija	Ncfpg
i	i	Cc
kontakte	kontakt	Ncmpa
koji	koji	Pi-mpn
su	biti	Var3p
često	često	Rgp
teško	teško	Rgp
dostupni	dostupan	Agpmpny
.	.	Z

Sve	sav	Agpnsny
navedeno	navesti	Appnsny
dovodi	dovoditi	Vmr3s
korisnike	korisnik	Ncmpa
pred	pred	Sa
birokratske	birokratski	Agpfpay
prepreke	prepreka	Ncfpa
u	u	Sl
ostvarivanju	ostvarivanje	Ncnsl
njihovih	njihov	Ps3npg
prava	pravo	Ncnpg
,	,	Z
obveza	obveza	Ncfsn
ili	ili	Cc
pravnih	pravni	Agpmpgy
interesa	interes	Ncmpg
.	.	Z

U	u	Sl
nastojanju	nastojanje	Ncnsl
da	da	Cs
se	sebe	Px--sa
takvo	takav	Pd-nsn
stanje	stanje	Ncnsn
trajno	trajno	Rgp
promijeni	promijeniti	Vmr3s
,	,	Z
potrebno	potreban	Agpnsny
je	biti	Var3s
temeljito	temeljito	Rgp
razmotriti	razmotriti	Vmn
i	i	Cc
redefinirati	redefinirati	Vmn
postupke	postupak	Ncmpa
pružanja	pružanje	Ncnsg
javnih	javan	Agpfpgy
usluga	usluga	Ncfpg
,	,	Z
pojednostavniti	pojednostavniti	Vmn
ih	oni	Pp3-pa
,	,	Z
a	a	Cc
one	onaj	Pd-fpn
za	za	Sa
koje	koji	Pi-mpa
se	sebe	Px--sa
utvrdi	utvrditi	Vmr3s
da	da	Cs
su	biti	Var3p
nepotrebni	nepotreban	Agpmpny
,	,	Z
ukinuti	ukinuti	Vmn
.	.	Z

Ujedno	ujedno	Rgp
je	biti	Var3s
u	u	Sa
današnje	današnji	Agpnsay
vrijeme	vrijeme	Ncnsa
uza	uz	Sa
sva	sav	Agpnpay
tehnološka	tehnološki	Agpnpay
dostignuća	dostignuće	Ncnpa
nužno	nužan	Agpnsny
i	i	Cc
lako	lako	Rgp
ostvarivo	ostvarivo	Rgp
osigurati	osigurati	Vmn
više	mnogo	Rgc
kanala	kanal	Ncmpg
za	za	Sa
rješavanje	rješavanje	Ncnsa
zahtjeva	zahtjev	Ncmpg
građana	građanin	Ncmpg
i	i	Cc
poslovnih	poslovan	Agpmpgy
subjekata	subjekt	Ncmpg
.	.	Z

4.1.1.	4.1.1.	Mdo

Odnos	odnos	Ncmsn
tijela	tijelo	Ncnsg
javne	javan	Agpfsgy
uprave	uprava	Ncfsg
i	i	Cc
korisnika	korisnik	Ncmpg
javnih	javan	Agpfpgy
usluga	usluga	Ncfpg

Modernizacija	modernizacija	Ncfsn
javne	javan	Agpfsgy
uprave	uprava	Ncfsg
podrazumijeva	podrazumijevati	Vmr3s
uključivanje	uključivanje	Ncnsa
korisnika	korisnik	Ncmpg
usluga	usluga	Ncfpg
u	u	Sa
rad	rad	Ncmsan
javne	javan	Agpfsgy
uprave	uprava	Ncfsg
.	.	Z

U	u	Sl
Republici	republika	Ncfsl
Hrvatskoj	Hrvatska	Npfsl
takav	takav	Pd-msn
je	biti	Var3s
pristup	pristup	Ncmsan
tek	tek	Rgp
u	u	Sl
začetku	začetak	Ncmsl
,	,	Z
a	a	Cc
građani	građanin	Ncmpn
i	i	Cc
poslovni	poslovan	Agpmpny
subjekti	subjekt	Ncmpn
ponajprije	ponajprije	Rgp
se	sebe	Px--sa
doživljavaju	doživljavati	Vmr3p
kao	kao	Cs
pasivni	pasivan	Agpmpny
korisnici	korisnik	Ncmpn
javnih	javan	Agpfpgy
usluga	usluga	Ncfpg
,	,	Z
dok	dok	Cs
je	biti	Var3s
zanemaren	zanemariti	Appmsnn
njihov	njihov	Ps3msn
potencijalni	potencijalan	Agpmsny
doprinos	doprinos	Ncmsn
unaprjeđenju	unaprjeđenje	Ncnsd
javne	javan	Agpfsgy
uprave	uprava	Ncfsg
.	.	Z

Iako	iako	Cs
je	biti	Var3s
obveza	obveza	Ncfsn
javnopravnih	javnopravni	Agpnpgy
tijela	tijelo	Ncnpg
davati	davati	Vmn
korisnicima	korisnik	Ncmpd
podatke	podatak	Ncmpa
,	,	Z
upute	uputa	Ncfpa
,	,	Z
obavijesti	obavijest	Ncfsg
i	i	Cc
pružati	pružati	Vmn
im	oni	Pp3-pd
stručnu	stručan	Agpfsay
pomoć	pomoć	Ncfsa
u	u	Sl
poslovima	posao	Ncmpl
radi	radi	Sg
kojih	koji	Pi-mpg
se	sebe	Px--sa
obraćaju	obraćati	Vmr3p
tim	taj	Pd-mpi
tijelima	tijelo	Ncnpi
te	te	Cc
upoznati	upoznati	Vmn

