postoji	postojati	Vmr3s
opasnost	opasnost	Ncfsn
od	od	Sg
visokonaponskog	visokonaponski	Agpmsgy
elektriciteta	elektricitet	Ncmsg
.	.	Z

9.	9.	Mdo
Poslovi	posao	Ncmpn
čiji	čiji	Pi-mpn
tempo	tempo	Ncmsan
određuju	određivati	Vmr3p
strojevi	stroj	Ncmpn
,	,	Z
a	a	Cc
obuhvaća	obuhvaćati	Vmr3s
plaćanje	plaćanje	Ncnsa
prema	prema	Sl
rezultatu	rezultat	Ncmsl
.	.	Z

10.	10.	Mdo

Poslovi	posao	Ncmpn
pri	pri	Sl
kojima	koji	Pi-mpl
su	biti	Var3p
izloženi	izložiti	Appmpny
štetnom	štetan	Agpmsly
utjecaju	utjecaj	Ncmsl
buke	buka	Ncfsg
i	i	Cc
vibracija	vibracija	Ncfsn
.	.	Z

