stranicama	stranica	Ncfpl
Vlade	vlada	Ncfsg
–	–	Z
Naziv	naziv	Ncmsn
tijela	tijelo	Ncnsg
nadležnog	nadležan	Agpnsgy
za	za	Sa
izradu	izrada	Ncfsa
nacrta	nacrtati	Vmr3s
Ministarstvo	ministarstvo	Ncnsa
pravosuđa	pravosuđe	Ncnsg
Koji	koji	Pi-mpn
su	biti	Var3p
predstavnici	predstavnik	Ncmpn
zainteresirane	zainteresiran	Agpfsgy
javnosti	javnost	Ncfsg
bili	biti	Vap-pm
uključeni	uključiti	Appmpny
u	u	Sa
postupak	postupak	Ncmsan
izrade	izrada	Ncfsg
odnosno	odnosno	Rgp
u	u	Sa
rad	rad	Ncmsan
stručne	stručan	Agpfsgy
radne	radni	Agpfsgy
skupine	skupina	Ncfsg
za	za	Sa
izradu	izrada	Ncfsa
nacrta	nacrt	Ncmpg
?	?	Z

Državni	državni	Agpmpny
službenici	službenik	Ncmpn
u	u	Sl
Ministarstvu	ministarstvo	Ncnsl
pravosuđa	pravosuđe	Ncnsg
Je	biti	Var3s
li	li	Qq
nacrt	nacrt	Ncmsn
bio	biti	Vap-sm
objavljen	objaviti	Appmsnn
na	na	Sl
internetskim	internetski	Agpfply
stranicama	stranica	Ncfpl
ili	ili	Cc
na	na	Sa
drugi	drugi	Mlomsan
odgovarajući	odgovarajući	Agpmsayn
način	način	Ncmsan
?	?	Z

Ako	ako	Cs
jest	biti	Var3s
,	,	Z
kada	kada	Cs
je	biti	Var3s
nacrt	nacrt	Ncmsn
objavljen	objaviti	Appmsnn
,	,	Z
na	na	Sl
kojoj	koji	Pi-fsl
internetskoj	internetski	Agpfsly
stranici	stranica	Ncfsl
i	i	Cc
koliko	koliko	Rgp
je	biti	Var3s
vremena	vrijeme	Ncnsg
ostavljeno	ostaviti	Appnsny
za	za	Sa
savjetovanje	savjetovanje	Ncnsa
?	?	Z

Ako	ako	Cs
nije	biti	Var3s
,	,	Z
zašto	zašto	Rgp
?	?	Z

Da	da	Qr
,	,	Z
na	na	Sl
središnjem	središnji	Agpmsly
državnom	državni	Agpmsly
portalu	portal	Ncmsl
e-Savjetovanja	e-savjetovanja	Ncnsn
.	.	Z

Pravilnik	pravilnik	Ncmsn
o	o	Sl
visini	visina	Ncfsl
nagrade	nagrada	Ncfsg
i	i	Cc
naknadi	naknada	Ncfsl
troškova	trošak	Ncmpg
javnog	javan	Agpmsgy
bilježnika	bilježnik	Ncmsg
kao	kao	Cs
povjerenika	povjerenik	Ncmsg
suda	sud	Ncmsg
u	u	Sl
postupku	postupak	Ncmsl
za	za	Sa
izdavanje	izdavanje	Ncnsa
,	,	Z
ispravak	ispravak	Ncmsan
,	,	Z
izmjenu	izmjena	Ncfsa
,	,	Z
opoziv	opoziv	Ncmsan
ili	ili	Cc
privremenu	privremen	Agpfsay
obustavu	obustava	Ncfsa
Europske	europski	Agpfsgy
potvrde	potvrda	Ncfsg
o	o	Sl
nasljeđivanju	nasljeđivanje	Ncnsl
objavljen	objaviti	Appmsnn
je	biti	Var3s
20.	20.	Mdo
kolovoza	kolovoz	Ncmsg
2015.	2015.	Mdo
,	,	Z
a	a	Cc
savjetovanje	savjetovanje	Ncnsn
je	biti	Var3s
trajalo	trajati	Vmp-sn
do	do	Sg
4.	4.	Mdo
rujna	rujan	Ncmsg
2015.	2015.	Mdo

Koji	koji	Pi-mpn
su	biti	Var3p
predstavnici	predstavnik	Ncmpn
zainteresirane	zainteresiran	Agpfsgy
javnosti	javnost	Ncfsg
dostavili	dostaviti	Vmp-pm
svoja	svoj	Px-npa
očitovanja	očitovanje	Ncnpa
?	?	Z
–	–	Z
ANALIZA	analiza	Ncfpg
DOSTAVLJENIH	dostaviti	Appfpgy
PRIMJEDBI	primjedba	Ncfpg
Primjedbe	primjedba	Ncfpn
koje	koji	Pi-fpn
su	biti	Var3p
prihvaćene	prihvatiti	Appfpny
–	i	Agpfpny
Primjedbe	primjedba	Ncfpn
koje	koji	Pi-fpn
nisu	biti	Var3p
prihvćene	prihvćen	Agpfpny
i	i	Cc
obrazloženje	obrazloženje	Ncnsa
razloga	razlog	Ncmpg
za	za	Sa
neprihvaćanje	neprihvaćanje	Ncnsa
Troškovi	trošak	Ncmpn
provedenog	provesti	Agpnsgy
savjetovanja	savjetovanje	Ncnsg
Provedba	provedba	Ncfsn
javnog	javan	Agpnsgy
savjetovanja	savjetovanje	Ncnsg
nije	biti	Var3s
iziskivala	iziskivati	Vmp-sf
dodatne	dodatan	Agpmpay
financijske	financijski	Agpmpay
troškove	trošak	Ncmpa
.	.	Z

