izvršitelje	izvršitelj	Ncmpa
obrade	obrada	Ncfsg
zaštićenih	zaštititi	Agpmpgy
podataka	podatak	Ncmpg
.	.	Z

Podatak	podatak	Ncmsn
–	–	Z
različite	različit	Agpfsgy
skupine	skupina	Ncfsg
elektroničkih	elektronički	Agpmpgy
zapisa	zapis	Ncmpg
koji	koji	Pi-mpn
imaju	imati	Vmr3p
vrijednost	vrijednost	Ncfsa
za	za	Sa
korisnike	korisnik	Ncmpa
koji	koji	Pi-mpn
s	sa	Si
njima	oni	Pp3-pi
postupaju	postupati	Vmr3p
.	.	Z

Pružatelji	pružatelj	Ncmpn
elektroničkih	elektronički	Agpfpgy
financijskih	financijski	Agpfpgy
usluga	usluga	Ncfpg
–	–	Z
subjekti	subjekt	Ncmpn
koje	koji	Pi-mpa
je	biti	Var3s
nadležno	nadležan	Agpnsny
tijelo	tijelo	Ncnsn
ovlastilo	ovlastiti	Vmp-sn
za	za	Sa
pružanje	pružanje	Ncnsa
elektroničkih	elektronički	Agpfpgy
financijskih	financijski	Agpfpgy
usluga	usluga	Ncfpg
.	.	Z

Računalni	računalni	Agpmsny
sigurnosni	sigurnosni	Agpmsny
incident	incident	Ncmsn
–	–	Sa
jedan	jedan	Mlcmsan
ili	ili	Cc
više	mnogo	Rgc
računalnih	računalni	Agpmpgy
sigurnosnih	sigurnosni	Agpmpgy
događaja	događaj	Ncmpg
koji	koji	Pi-mpn
su	biti	Var3p
narušili	narušiti	Vmp-pm
odnosno	odnosno	Rgp
narušavaju	narušavati	Vmr3p
sigurnost	sigurnost	Ncfsa
informacijskog	informacijski	Agpmsgy
sustava	sustav	Ncmsg
.	.	Z

Sigurnosne	sigurnosni	Agpfpny
mjere	mjera	Ncfpn
–	–	Z
opća	opći	Agpnpay
pravila	pravilo	Ncnpa
zaštite	zaštita	Ncfsg
podataka	podatak	Ncmpg
koja	koji	Pi-fsn
se	sebe	Px--sa
realiziraju	realizirati	Vmr3p
na	na	Sl
fizičkoj	fizički	Agpfsly
,	,	Z
tehničkoj	tehnički	Agpfsly
ili	ili	Cc
organizacijskoj	organizacijski	Agpfsly
razini	razina	Ncfsl
.	.	Z

Sustav	sustav	Ncmsn
identifikacije	identifikacija	Ncfsg
i	i	Cc
autentifikacije	autentifikacija	Ncfsg
–	–	Z
sustav	sustav	Ncmsan
kojim	koji	Pi-msi
se	sebe	Px--sa
utvrđuje	utvrđivati	Vmr3s
i	i	Cc
verificira	verificirati	Vmr3s
identitet	identitet	Ncmsan
osoba	osoba	Ncfpg
,	,	Z
uređaja	uređaj	Ncmpg
ili	ili	Cc
usluga	usluga	Ncfpg
na	na	Sl
informacijskim	informacijski	Agpmply
sustavima	sustav	Ncmpl
.	.	Z

Vjerodajnice	vjerodajnica	Ncfpn
–	–	Z
skup	skup	Ncmsan
podataka	podatak	Ncmpg
kojim	koji	Pi-msi
se	sebe	Px--sa
predstavlja	predstavljati	Vmr3s
korisnik	korisnik	Ncmsn
elektroničke	elektronički	Agpfsgy
usluge	usluga	Ncfsg
,	,	Z
a	a	Cc
služi	služiti	Vmr3s
kao	kao	Cs
dokaz	dokaz	Ncmsn
za	za	Sa
provjeru	provjera	Ncfsa
elektroničkog	elektronički	Agpmsgy
identiteta	identitet	Ncmsg
(	(	Z
e-ID	e-ID	Npmsn
)	)	Z
kako	kako	Cs
bi	biti	Vaa3s
se	sebe	Px--sa
omogućio	omogućiti	Vmp-sm
pristup	pristup	Ncmsan
elektroničkim	elektronički	Agpfpiy
uslugama	usluga	Ncfpi
(	(	Z
e-uslugama	e-uslugama	Npfsn
)	)	Z
.	.	Z

Zaštićeni	zaštititi	Appmpny
podaci	podatak	Ncmpn
–	–	Agpmpny
podaci	podatak	Ncmpn
koji	koji	Pi-mpn
zbog	zbog	Sg
svog	svoj	Px-msg
sadržaja	sadržaj	Ncmsg
imaju	imati	Vmr3p
osobit	osobit	Agpmsann
značaj	značaj	Ncmsan
za	za	Sa
vrijednosti	vrijednost	Ncfpa
štićene	štititi	Appfpny
u	u	Sl
demokratskom	demokratski	Agpnsly
društvu	društvo	Ncnsl
,	,	Z
zbog	zbog	Sg
čega	što	Pi3n-g
ih	oni	Pp3-pa
država	država	Ncfsn
prepoznaje	prepoznavati	Vmr3s
kao	kao	Cs
osjetljive	osjetljiv	Agpfpny
te	te	Cc
ih	oni	Pp3-pa
razvrstava	razvrstavati	Vmr3s
u	u	Sa
različite	različit	Agpfpay
skupine	skupina	Ncfpa
podataka	podatak	Ncmpg
za	za	Sa
koje	koji	Pi-mpa
vrijede	vrijediti	Vmr3p
specifični	specifičan	Agpmpny
zahtjevi	zahtjev	Ncmpn
postupanja	postupanje	Ncnsg
u	u	Sl
odnosu	odnos	Ncmsl
na	na	Sa
svojstva	svojstvo	Ncnpa
podatka	podatak	Ncmsg
kao	kao	Cs
što	što	Cs
su	biti	Var3p
povjerljivost	povjerljivost	Ncfsa
,	,	Z
cjelovitost	cjelovitost	Ncfsa
,	,	Z
raspoloživost	raspoloživost	Ncfsa
,	,	Z
odnosno	odnosno	Rgp
privatnost	privatnost	Ncfsa
.	.	Z

Kratice	kratica	Ncfpn

CARNet	CARNet	Npmsn
Hrvatska	hrvatski	Agpfsny
akademska	akademski	Agpfsny
i	i	Cc
istraživačka	istraživački	Agpfsny
mreža	mreža	Ncfsn
(	(	Z
eng.	eng.	Y

Croatian	Croatian	Npmsn
Academic	Academic	Xf
and	and	Xf
Research	Research	Xf
Network	Network	Npmsn
)	)	Z
.	.	Z

CERT	ceri	Agpnsny
(	(	Z
Computer	Computer	Npfsn
Emergency	Emergency	Npfsn
Response	Response	Npfsn
Team	Team	Npfsn
)	)	Z
Uobičajena	uobičajiti	Appfsny
kratica	kratica	Ncfsn
za	za	Sa
skupinu	skupina	Ncfsa
stručnjaka	stručnjak	Ncmpg
odgovornih	odgovoran	Agpmpgy
za	za	Sa
rješavanje	rješavanje	Ncnsa
sigurnosnih	sigurnosni	Agpmpgy
incidenata	incident	Ncmpg
na	na	Sl
računalnim	računalni	Agpfply
mrežama	mreža	Ncfpl
.	.	Z

U	u	Sl
kontekstu	kontekst	Ncmsl
Strategije	strategija	Ncfsg
,	,	Z
kratica	kratica	Ncfsn
CERT	CERT	Npmsn
se	sebe	Px--sa
koristi	koristiti	Vmr3s
za	za	Sa
svaku	svaki	Pi-fsa
organizacijsku	organizacijski	Agpfsay
cjelinu	cjelina	Ncfsa
,	,	Z
podcjelinu	podcjelina	Ncfsa
ili	ili	Cc
pojedinca	pojedinac	Ncmsay
odgovornog	odgovoran	Agpmsgy
za	za	Sa
koordinaciju	koordinacija	Ncfsa
,	,	Z
prevenciju	prevencija	Ncfsa
i	i	Cc
zaštitu	zaštita	Ncfsa
od	od	Sg
računalnih	računalni	Agpfpgy
ugroza	ugroza	Ncfpg
sigurnosti	sigurnost	Ncfsg
informacijskih	informacijski	Agpmpgy
sustava	sustav	Ncmpg
.	.	Z

Uz	uz	Sa
kraticu	kratica	Ncfsa
CERT	cert	Ncmsan
,	,	Z
u	u	Sl
međunarodnoj	međunarodni	Agpfsly
praksi	praksa	Ncfsl
prisutna	prisutan	Agpfsny
je	biti	Var3s
i	i	Qo
kratica	kratica	Ncfsn
CSIRT	CSIRT	Npmsn
(	(	Z
Computer	Computer	Xf
Security	Security	Xf
Incident	incident	Ncmsn
Response	Responsa	Npfsg
Team	Team	Npfsg
)	)	Z
.	.	Z

Croatian	Croatian	Npmsn
Internet	Internet	Npmsn
eXchange	eXchange	Npmsn
(	(	Z
CIX	CIX	Npmsn
)	)	Z
Hrvatsko	hrvatski	Agpnsny
nacionalno	nacionalan	Agpnsny
središte	središte	Ncnsn
za	za	Sa
razmjenu	razmjena	Ncfsa
internetskog	internetski	Agpmsgy
prometa	promet	Ncmsg
udomljeno	udomiti	Appnsny
u	u	Sl
Sveučilišnom	sveučilišni	Agpmsly
računskom	računski	Agpmsly
centru	centar	Ncmsl
(	(	Z
Srcu	srce	Ncnsl
)	)	Z
,	,	Z
koje	koji	Pi-nsn
je	biti	Var3s
otvoreno	otvoriti	Appnsny
za	za	Sa
sve	sav	Agpmpay
davatelje	davatelj	Ncmpa
internetskih	internetski	Agpfpgy
usluga	usluga	Ncfpg
u	u	Sl
RH	RH	Npfsl
(	(	Z
za	za	Sa
komercijalne	komercijalan	Agpfpay
i	i	Cc
za	za	Sa
nekomercijalne	nekomercijalan	Agpmpay
,	,	Z
odnosno	odnosno	Rgp
privatne	privatan	Agpfsgy
mreže	mreža	Ncfsg
)	)	Z
.	.	Z

EFU	EF	Npmsd
Elektroničke	elektronički	Agpfsgy
financijske	financijski	Agpfsgy
usluge	usluga	Ncfsg
.	.	Z
e-Građani	e-građan	Agpmsny
Sustav	sustav	Ncmsn
e-Građani	e-građan	Agpmsny
je	biti	Var3s
dio	dio	Ncmsn
državnog	državni	Agpmsgy
informacijskog	informacijski	Agpmsgy
sustava	sustav	Ncmsg
,	,	Z
a	a	Cc
čine	činiti	Vmr3p
ga	on	Pp3msa
središnji	središnji	Agpmsny
državni	državni	Agpmsny
portal	portal	Ncmsn
,	,	Z
nacionalni	nacionalan	Agpmsny
identifikacijski	identifikacijski	Agpmsny
i	i	Cc
autentifikacijski	autentifikacijski	Agpmsayn
sustav	sustav	Ncmsan
i	i	Cc
sustav	sustav	Ncmsn
osobnog	osoban	Agpmsgy
korisničkog	korisnički	Agpmsgy
pretinca	pretinac	Ncmsg
.	.	Z

EU	EU	Npmsn
Europska	europski	Agpfsny
unija	unija	Ncfsn
.	.	Z
e-usluga	e-uslug	Agpfsny
Elektronička	elektronički	Agpfsny
usluga	usluga	Ncfsn
.	.	Z

EUROJUST	EUROJUST	Xf
The	The	Xf
European	European	Xf
Union	union	Xf
’	’	Z
s	sa	Si
Judicial	Judicial	Npfsi
Cooperation	Cooperation	Npfsi
Unit	Unit	Npfsi
.	.	Z

EUROPOL	EUROPOL	Xf
The	The	Xf
European	European	Xf
Police	Polica	Npfsg
Office	Offica	Npfsg
.	.	Z

EFTPOS	eftpos	Agpmsny
sustav	sustav	Ncmsn
Electronic	electronic	Xf
Fund	Fund	Xf
Transfer	transfer	Ncmsn
Point	Point	Xf
Of	Of	Xf
Sale	Sale	Xf
–	–	Z
terminal	terminal	Ncmsn
na	na	Sl
prodajnom	prodajni	Agpnsly
mjestu	mjesto	Ncnsl
namijenjen	namijeniti	Appmsnn
bezgotovinskom	bezgotovinski	Agpnsly
plaćanju	plaćanje	Ncnsl
pomoću	pomoć	Sg
kojeg	koji	Pi-msg
se	sebe	Px--sa
transakcije	transakcija	Ncfpn
provode	provoditi	Vmr3p
elektroničkim	elektronički	Agpmsiy
putem	put	Ncmsi
.	.	Z

HITRONet	HITRONet	Npmsn
Računalna	računalni	Agpfsny
komunikacijska	komunikacijski	Agpfsny
mreža	mreža	Ncfsn
tijela	tijelo	Ncnsg
državne	državni	Agpfsgy
uprave	uprava	Ncfsg
.	.	Z

HR	HR	Npmsn
ISO	ISO	Npmsn
/	/	Z
IEC	IEC	Npmsn
27000	27000	Mdc
Skup	skup	Ncmsan
međunarodnih	međunarodni	Agpmpgy
normativnih	normativan	Agpmpgy
dokumenata	dokument	Ncmpg
za	za	Sa
područje	područje	Ncnsa
upravljanja	upravljanje	Ncnsg
informacijskom	informacijski	Agpfsiy
sigurnošću	sigurnost	Ncfsi
,	,	Z
prihvaćen	prihvatiti	Appmsnn
kao	kao	Cs
Hrvatska	Hrvatska	Npfsn
norma	norma	Ncfsn
.	.	Z

NATO	NATO	Agpnsny
Organizacija	organizacija	Ncfsn
Sjevernoatlantskog	sjevernoatlantski	Agpmsgy
ugovora	ugovor	Ncmsg
.	.	Z

NIAS	nias	Agpmsny
Nacionalni	nacionalan	Agpmsny
identifikacijski	identifikacijski	Agpmsny
i	i	Cc
autentifikacijski	autentifikacijski	Agpmsayn
sustav	sustav	Ncmsan
.	.	Z

OIB	oib	Agpmsny
Osobni	osoban	Agpmsny
identifikacijski	identifikacijski	Agpmsny
broj	broj	Ncmsn
.	.	Z

RH	ri	Agpfsny
Republika	republika	Ncfsn
Hrvatska	Hrvatska	Npfsn
.	.	Z

Strategija	strategija	Ncfsn
Nacionalna	nacionalan	Agpfsny
strategija	strategija	Ncfsn
kibernetičke	kibernetički	Agpfsgy
sigurnosti	sigurnost	Ncfsg
.	.	Z

AKCIJSKI	akcijski	Agpmsny
PLAN	plan	Ncmsn
ZA	za	Sa
PROVEDBU	provedba	Ncfsa
NACIONALNE	nacionalan	Agpfsgy
STRATEGIJE	strategija	Ncfsg
KIBERNETIČKE	kibernetički	Agpfsgy
SIGURNOSTI	sigurnost	Ncfsg

1.	1.	Mdo
UVOD	uvod	Ncmsn

Ovim	ovaj	Pd-msi
Akcijskim	akcijski	Agpmsiy
planom	plan	Ncmsi
razrađuju	razrađivati	Vmr3p
se	sebe	Px--sa
ciljevi	cilj	Ncmpn
definirani	definirati	Appmpny
Nacionalnom	nacionalan	Agpfsiy
strategijom	strategija	Ncfsi
kibernetičke	kibernetički	Agpfsgy
sigurnosti	sigurnost	Ncfsg
(	(	Z
dalje	daleko	Rgc
u	u	Sl
tekstu	tekst	Ncmsl
:	:	Z
Strategija	strategija	Ncfsn
)	)	Z
na	na	Sa
način	način	Ncmsan
da	da	Cs
se	sebe	Px--sa
njime	on	Ncfpn
utvrđuju	utvrđivati	Vmr3p
provedbene	provedbeni	Agpfpny
mjere	mjera	Ncfpn
nužne	nužan	Agpfpny
za	za	Sa
ostvarenje	ostvarenje	Ncnsa
tih	taj	Pd-mpg
ciljeva	cilj	Ncmpg
.	.	Z

Akcijski	akcijski	Agpmsny
plan	plan	Ncmsn
zamišljen	zamišljen	Appmsnn
je	biti	Var3s
kao	kao	Cs
živi	živ	Agpmsny
dokument	dokument	Ncmsn
koji	koji	Pi-msn
omogućuje	omogućivati	Vmr3s
sustavan	sustavan	Agpmsann
nadzor	nadzor	Ncmsan
provedbe	provedba	Ncfsg
Strategije	strategija	Ncfsg
i	i	Cc
predstavlja	predstavljati	Vmr3s
kontrolni	kontrolan	Agpmsayn
mehanizam	mehanizam	Ncmsan
pomoću	pomoć	Sg
kojega	koji	Pi-msg
će	htjeti	Var3s
se	sebe	Px--sa
moći	moći	Vmn
vidjeti	vidjeti	Vmn
je	biti	Var3s
li	li	Qq
određena	odrediti	Appfsny
mjera	mjera	Ncfsn
provedena	provesti	Appfsny
u	u	Sl
potpunosti	potpunost	Ncfsl
,	,	Z
je	biti	Var3s
li	li	Qq
cilj	cilj	Ncmsn
postignut	postignuti	Appmsnn
ili	ili	Cc
je	biti	Var3s
ciljeve	cilj	Ncmpa
i	i	Cc
mjere	mjera	Ncfpa
potrebno	potreban	Agpnsny
redefinirati	redefinirati	Vmn
u	u	Sl
skladu	sklad	Ncmsl
s	sa	Si
novim	nov	Agpfpiy
potrebama	potreba	Ncfpi
.	.	Z

Akcijskim	akcijski	Agpmsiy
planom	plan	Ncmsi
utvrđuju	utvrđivati	Vmr3p
se	sebe	Px--sa
tijela	tijelo	Ncnpn
odgovorna	odgovoran	Agpfsny
za	za	Sa
provedbu	provedba	Ncfsa
predviđenih	predvidjeti	Agpfpgy
mjera	mjera	Ncfpg
,	,	Z
u	u	Sl
svojstvu	svojstvo	Ncnsl
nositelja	nositelj	Ncmpg
i	i	Cc
sunositelja	sunositelj	Ncmpg
.	.	Z

Sukladno	sukladno	Rgp
procjeni	procjena	Ncfsl
i	i	Cc
potrebama	potreba	Ncfpl
provedbe	provedba	Ncfsg
pojedine	pojedini	Agpfsgy
mjere	mjera	Ncfsg
,	,	Z
nositelji	nositelj	Ncmpn
i	i	Cc
sunositelji	sunositelj	Ncmpn
mogu	moći	Vmr3p
uključiti	uključiti	Vmn
i	i	Qo
druge	drugi	Mlompa
sudionike	sudionik	Ncmpa
u	u	Sa
provedbu	provedba	Ncfsa
mjera	mjera	Ncfpg
iz	iz	Sg
ovog	ovaj	Pd-msg
Akcijskog	akcijski	Agpmsgy
plana	plan	Ncmsg
.	.	Z

Nadzor	nadzor	Ncmsn
provedbe	provedba	Ncfsg
nad	nad	Si
ovim	ovaj	Agpmsiy
Akcijskim	akcijski	Agpmsiy
planom	plan	Ncmsi
provodit	provoditi	Vmn
će	htjeti	Var3s

