visokom	visok	Agpnsly
obrazovanju	obrazovanje	Ncnsl
.	.	Z

Članak	članak	Ncmsn
17.	17.	Mdo

Na	na	Sa
pitanja	pitanje	Ncnpa
koja	koji	Pi-npn
nisu	biti	Var3p
uređena	urediti	Appnpny
ovim	ovaj	Pd-msi
Zakonom	zakon	Ncmsi
primjenjuju	primjenjivati	Vmr3p
se	sebe	Px--sa
odredbe	odredba	Ncfpn
Zakona	zakon	Ncmsg
o	o	Sl
ustanovama	ustanova	Ncfpl
i	i	Cc
propisa	propis	Ncmpg
koji	koji	Pi-mpn
reguliraju	regulirati	Vmr3p
sustav	sustav	Ncmsan
visokog	visok	Agpnsgy
obrazovanja	obrazovanje	Ncnsg
i	i	Cc
znanstvenu	znanstven	Agpfsay
djelatnost	djelatnost	Ncfsa
.	.	Z

Članak	članak	Ncmsn
18.	18.	Mdo

Ovaj	ovaj	Pd-msn
Zakon	zakon	Ncmsn
stupa	stupati	Vmr3s
na	na	Sa
snagu	snaga	Ncfsa
osmoga	osmi	Mlomsg
dana	dan	Ncmsg
od	od	Sg
dana	dan	Ncmsg
objave	objava	Ncfsg
u	u	Sl
»	»	Z
Narodnim	narodni	Agpfply
novinama	novina	Ncfpl
«	«	Z
.	.	Z

Klasa	klasa	Ncfsn
:	:	Z
022	022	Mdc
-	-	Z
03/15	03/15	Mdc
-	-	Z
01/149	01/149	Mdc
Zagreb	Zagreb	Npmsn
,	,	Z
25.	25.	Mdo
rujna	rujan	Ncmsg
2015.	2015.	Mdo

HRVATSKI	hrvatski	Agpmsny
SABOR	sabor	Ncmsn

Predsjednik	predsjednik	Ncmsn
Hrvatskoga	hrvatski	Agpmsgy
sabora	sabor	Ncmsg
Josip	Josip	Npmsn
Leko	Leko	Npmsn
,	,	Z
v.	v.	Y
r.	r.	Y

