pretplatnički	pretplatnički	Agpmsny
ugovor	ugovor	Ncmsn
sklopljen	sklopiti	Appmsnn
s	sa	Si
posebnom	poseban	Agpfsiy
odredbom	odredba	Ncfsi
o	o	Sl
obveznom	obvezan	Agpnsly
trajanju	trajanje	Ncnsl
sukladno	sukladno	Rgp
odredbi	odredba	Ncfsl
članka	članak	Ncmsg
18.	18.	Mdo
navedenih	naveden	Agpmpgy
Općih	opći	Agpmpgy
uvjeta	uvjet	Ncmpg
operatora	operator	Ncmpg
,	,	Z
a	a	Cc
krivnjom	krivnja	Ncfsi
korisnika	korisnik	Ncmpg
dođe	doći	Vmr3s
do	do	Sg
raskida	raskid	Ncmsg
pretplatničkog	pretplatnički	Agpmsgy
ugovora	ugovor	Ncmsg
prije	prije	Sg
isteka	istek	Ncmsg
razdoblja	razdoblje	Ncnsg
obveznog	obvezan	Agpnsgy
trajanja	trajanje	Ncnsg
ugovora	ugovor	Ncmsg
,	,	Z
korisnik	korisnik	Ncmsn
će	htjeti	Var3s
biti	biti	Van
dužan	dužan	Agpmsnn
platiti	platiti	Vmn
mjesečnu	mjesečan	Agpfsay
naknadu	naknada	Ncfsa
za	za	Sa
ostatak	ostatak	Ncmsan
razdoblja	razdoblje	Ncnsg
obveznog	obvezan	Agpnsgy
trajanja	trajanje	Ncnsg
ugovora	ugovor	Ncmsg
ili	ili	Cc
naknadu	naknada	Ncfsa
u	u	Sl
visini	visina	Ncfsl
popusta	popust	Ncmpg
koje	koji	Pi-mpa
je	biti	Var3s
ostvario	ostvariti	Vmp-sm
ako	ako	Cs
je	biti	Var3s
plaćanje	plaćanje	Ncnsn
te	taj	Pd-fsg
naknade	naknada	Ncfsg
za	za	Sa
njega	njega	Ncfpa
povoljnije	povoljno	Rgc
,	,	Z
a	a	Cc
što	što	Pi3n-n
će	htjeti	Var3s
biti	biti	Van
detaljno	detaljno	Rgp
utvrđeno	utvrditi	Appnsny
posebnim	poseban	Agpmpiy
uvjetima	uvjet	Ncmpi
pojedinog	pojedini	Agpmsgy
tarifnog	tarifan	Agpmsgy
modela	model	Ncmsg
i	i	Cc
/	/	Z
ili	ili	Cc
paketa	paket	Ncmsg
ili	ili	Cc
u	u	Sl
cjeniku	cjenik	Ncmsl
usluga	usluga	Ncfpg
.	.	Z

Stoga	stoga	Rgp
sud	sud	Ncmsn
smatra	smatrati	Vmr3s
da	da	Cs
je	biti	Var3s
tuženik	tuženik	Ncmsn
pravilno	pravilno	Rgp
primjenom	primjena	Ncfsi
odredbe	odredba	Ncfsg
članka	članak	Ncmsg
12.	12.	Mdo
stavak	stavak	Ncmsn
1.	1.	Mdo
točke	točka	Ncfsg
11.	11.	Mdo
u	u	Sl
svezi	sveza	Ncfsl
odredbe	odredba	Ncfsg
članka	članak	Ncmsg
51.	51.	Mdo

Zakona	zakon	Ncmsg
o	o	Sl
elektroničkim	elektronički	Agpfply
komunikacijama	komunikacija	Ncfpl
i	i	Cc
donio	donijeti	Vmp-sm
osporavanu	osporavati	Agpfsay
odluku	odluka	Ncfsa
te	te	Cc
istom	isti	Agpfsiy
okončao	okončati	Vmp-sm
postupak	postupak	Ncmsan
u	u	Sl
povodu	povod	Ncmsl
zahtjeva	zahtjev	Ncmpg
za	za	Sa
rješavanje	rješavanje	Ncnsa
spora	spor	Ncmsg
.	.	Z

Slijedom	slijed	Ncmsi
navedenoga	naveden	Agpmsgy
sud	sud	Ncmsn
smatra	smatrati	Vmr3s
da	da	Cs
je	biti	Var3s
tuženik	tuženik	Ncmsn
pravilnom	pravilan	Agpfsiy
primjenom	primjena	Ncfsi
materijalnog	materijalan	Agpnsgy
prava	pravo	Ncnsg
i	i	Cc
na	na	Sl
temelju	temelj	Ncmsl
pravilno	pravilno	Rgp
utvrđenog	utvrditi	Appnsgy
činjeničnog	činjeničan	Agpnsgy
stanja	stanje	Ncnsg
,	,	Z
primjenom	primjena	Ncfsi
odredbe	odredba	Ncfsg
članka	članak	Ncmsg
51.	51.	Mdo
stavak	stavak	Ncmsn
6.	6.	Mdo
i	i	Cc
stavak	stavak	Ncmsan
8.	8.	Mdo
Zakona	zakon	Ncmsg
odbio	odbiti	Vmp-sm
zahtjev	zahtjev	Ncmsan
tužitelja	tužitelj	Ncmpg
za	za	Sa
rješavanje	rješavanje	Ncnsa
spora	spor	Ncmsg
,	,	Z
pri	pri	Sl
čemu	što	Pi3n-l
nije	biti	Var3s
povrijedio	povrijediti	Vmp-sm
zakon	zakon	Ncmsan
na	na	Sa
njegovu	njegov	Ps3fsa
štetu	šteta	Ncfsa
,	,	Z
te	te	Cc
je	biti	Var3s
primjenom	primjena	Ncfsi
članka	članak	Ncmsg
57.	57.	Mdo
stavka	stavak	Ncmsg
1.	1.	Mdo
ZUS-a	ZUS	Npmsg
tužbeni	tužbeni	Agpmsayn
zahtjev	zahtjev	Ncmsan
tužitelja	tužitelj	Ncmpg
valjalo	valjati	Vmp-sn
odbiti	odbiti	Vmn
kao	kao	Cs
neosnovan	neosnovan	Agpmsnn
.	.	Z

UPUTA	uputa	Ncfsn
O	o	Sl
PRAVNOM	pravni	Agpmsly
LIJEKU	lijek	Ncmsl

Protiv	protiv	Sg
ove	ovaj	Pd-fsg
presude	presuda	Ncfsg
dopuštena	dopustiti	Appfsny
je	biti	Var3s
žalba	žalba	Ncfsn
Visokom	visok	Agpmsdy
upravnom	upravan	Agpmsdy
sudu	sud	Ncmsd
Republike	republika	Ncfsg
Hrvatske	Hrvatska	Npfsg
.	.	Z

Žalba	žalba	Ncfsn
se	sebe	Px--sa
podnosi	podnositi	Vmr3s
ovome	ovaj	Pd-msd
sudu	sud	Ncmsd
u	u	Sl
roku	rok	Ncmsl
od	od	Sg
15	15	Mdc
dana	dan	Ncmpg
od	od	Sg
dana	dan	Ncmsg
dostave	dostava	Ncfsg
presude	presuda	Ncfsg
,	,	Z
u	u	Sl
dovoljnom	dovoljan	Agpmsly
broju	broj	Ncmsl
primjeraka	primjerak	Ncmpg
za	za	Sa
sud	sud	Ncmsan
i	i	Cc
sve	sav	Agpfpay
stranke	stranka	Ncfpa
u	u	Sl
sporu	spor	Ncmsl
.	.	Z

Žalba	žalba	Ncfsn
odgađa	odgađati	Vmr3s
izvršenje	izvršenje	Ncnsa
pobijane	pobijati	Agpfsgy
presude	presuda	Ncfsg
.	.	Z

Broj	broj	Ncmsn
:	:	Z
7	7	Mdc
UsI-398	UsI-398	Mdc
/	/	Z
15	15	Mdc
-	-	Z
11	11	Mdc

Osijek	osijek	Ncmsn
,	,	Z
29.	29.	Mdo
rujna	rujan	Ncmsg
2015.	2015.	Mdo

Sutkinja	sutkinja	Ncfsn
Blanka	Blanka	Npfsn
Sajter	Sajter	Npfsn
,	,	Z
v.	v.	Y
r.	r.	Y

