neprofitne	neprofitan	Agpfsgy
organizacije	organizacija	Ncfsg
za	za	Sa
to	taj	Pd-nsa
ovlašteno	ovlastiti	Appnsny
.	.	Z

Internim	interni	Agpmpiy
aktima	akt	Ncmpi
zakonski	zakonski	Agpmsny
zastupnik	zastupnik	Ncmsn
neprofitne	neprofitan	Agpfsgy
organizacije	organizacija	Ncfsg
uređuje	uređivati	Vmr3s
poslovanje	poslovanje	Ncnsa
neprofitne	neprofitan	Agpfsgy
organizacije	organizacija	Ncfsg
u	u	Sl
organizacijskom	organizacijski	Agpmsly
smislu	smisao	Ncmsl
,	,	Z
kao	kao	Cs
i	i	Cc
ostala	ostali	Agpnpay
pravila	pravilo	Ncnpa
poslovanja	poslovanje	Ncnsg
.	.	Z

Takvi	takav	Pd-mpn
se	sebe	Px--sa
akti	akt	Ncmpn
primjenjuju	primjenjivati	Vmr3p
isključivo	isključivo	Rgp
na	na	Sa
zaposlenike	zaposlenik	Ncmpa
neprofitne	neprofitan	Agpfsgy
organizacije	organizacija	Ncfsg
,	,	Z
odnosno	odnosno	Rgp
druge	drugi	Mlofpn
osobe	osoba	Ncfpn
koje	koji	Pi-fpn
su	biti	Var3p
na	na	Sa
bilo	bilo	Qo
koji	koji	Pi-msan
način	način	Ncmsan
angažirane	angažirati	Appfpny
u	u	Sl
radu	rad	Ncmsl
tj.	tj.	Sl
obavljanju	obavljanje	Ncnsl
djelatnosti	djelatnost	Ncfsg
neprofitne	neprofitan	Agpfsgy
organizacije	organizacija	Ncfsg
.	.	Z

