komunikacijskoj	komunikacijski	Agpfsly
mreži	mreža	Ncfsl
na	na	Sl
fiksnoj	fiksan	Agpfsly
lokaciji	lokacija	Ncfsl
za	za	Sa
privatne	privatan	Agpmpay
i	i	Cc
poslovne	poslovan	Agpmpay
korisnike	korisnik	Ncmpa
.	.	Z

Regulatorna	regulatoran	Agpfsny
obveza	obveza	Ncfsn
pristupa	pristup	Ncmsg
je	biti	Var3s
utvrđena	utvrditi	Appfsny
nakon	nakon	Sg
provedene	provesti	Agpfsgy
analize	analiza	Ncfsg
mjerodavnih	mjerodavan	Agpnpgy
tržišta	tržište	Ncnpg
kao	kao	Cs
dokumenta	dokument	Ncmsg
u	u	Sl
kojem	koji	Pi-msl
su	biti	Var3p
određene	odrediti	Appfpny
regulatorne	regulatoran	Agpfpny
i	i	Cc
obveze	obveza	Ncfpa
i	i	Cc
definiran	definirati	Appmsnn
njihov	njihov	Ps3msan
sadržaj	sadržaj	Ncmsan
.	.	Z

Navedenom	naveden	Agpfsiy
obvezom	obveza	Ncfsi
propisani	propisati	Appmpny
su	biti	Var3p
rokovi	rok	Ncmpn
i	i	Cc
uvjeti	uvjet	Ncmpn
realizacije	realizacija	Ncfsg
veleprodajnih	veleprodajni	Agpfpgy
usluga	usluga	Ncfpg
te	te	Cc
zabranjeno	zabraniti	Appnsny
svako	svaki	Pi-nsa
postupanje	postupanje	Ncnsa
koje	koji	Pi-nsn
bi	biti	Vaa3s
moglo	moći	Vmp-sn
uskraćivati	uskraćivati	Vmn
,	,	Z
odugovlačiti	odugovlačiti	Vmn
,	,	Z
otežavati	otežavati	Vmn
ili	ili	Cc
neopravdano	neopravdano	Rgp
uvjetovati	uvjetovati	Vmn
drugim	drugi	Mlompd
operatorima	operator	Ncmpd
realizaciju	realizacija	Ncfsa
svojih	svoj	Px-fpg
veleprodajnih	veleprodajni	Agpfpgy
usluga	usluga	Ncfpg
.	.	Z

Zakašnjenje	zakašnjenje	Ncnsn
povlači	povlačiti	Vmr3s
za	za	Si
sobom	sebe	Px--si
obvezu	obveza	Ncfsa
plaćanja	plaćanje	Ncnsg
naknada	naknada	Ncfpg
u	u	Sl
iznosima	iznos	Ncmpl
i	i	Cc
pod	pod	Si
uvjetima	uvjet	Ncmpi
koje	koji	Pi-mpa
je	biti	Var3s
HAKOM	HAKOM	Npmsn
propisao	propisati	Vmp-sm
.	.	Z

Stoga	stoga	Rgp
je	biti	Var3s
spor	spor	Ncmsn
o	o	Sl
naknadama	naknada	Ncfpl
koje	koji	Pi-fpn
su	biti	Var3p
sadržane	sadržati	Appfpny
u	u	Sl
standardnim	standardan	Agpfply
ponudama	ponuda	Ncfpl
HT-a	HT	Npmsg
neposredno	neposredno	Rgp
vezan	vezan	Agpmsnn
uz	uz	Sa
ZEK-a	ZEK-a	Pd-nsa
jer	jer	Cs
naknade	naknada	Ncfpn
proizlaze	proizlaziti	Vmr3p
iz	iz	Sg
odredaba	odredba	Ncfpg
tog	taj	Pd-msg
Zakona	zakon	Ncmsg
što	što	Cs
nadalje	nadalje	Rgp
otklanja	otklanjati	Vmr3s
prigovor	prigovor	Ncmsan
tužiteljev	tužiteljev	Ncmsan
o	o	Sl
nenadležnosti	nenadležnost	Ncfsl
tuženika	tuženik	Ncmpg
.	.	Z

Slijedom	slijed	Sg
toga	taj	Pd-nsg
niti	niti	Qo
sudske	sudski	Agpfsgy
odluke	odluka	Ncfsg
na	na	Sa
koje	koji	Pi-fpa
se	sebe	Px--sa
tužitelj	tužitelj	Ncmsn
poziva	pozivati	Vmr3s
nisu	biti	Var3p
odlučne	odlučan	Agpfpny
,	,	Z
niti	niti	Qo
mjerodavne	mjerodavan	Agpfpny
za	za	Sa
rješenje	rješenje	Ncnsa
predmetne	predmetni	Agpfsgy
stvari	stvar	Ncfsg
u	u	Sl
kojem	koji	Pi-msl
pravcu	pravac	Ncmsl
osnovano	osnovati	Appnsny
navodi	navoditi	Vmr3s
i	i	Cc
tuženik	tuženik	Ncmsn
u	u	Sl
obrazloženju	obrazloženje	Ncnsl
osporenog	osporiti	Agpnsgy
rješenja	rješenje	Ncnsg
.	.	Z

U	u	Sl
svezi	sveza	Ncfsl
prigovora	prigovor	Ncmsg
tužitelja	tužitelj	Ncmpg
da	da	Cs
izreka	izreka	Ncfsn
osporenog	osporiti	Agpnsgy
rješenja	rješenje	Ncnsg
nije	biti	Var3s
određena	određen	Agpfsny
u	u	Sl
smislu	smisao	Ncmsl
članka	članak	Ncmsg
98.	98.	Mdo
stavka	stavak	Ncmsg
3.	3.	Mdo
ZUP-a	ZUP	Npmsg
,	,	Z
valja	valjati	Vmr3s
dodati	dodati	Vmn
da	da	Cs
se	sebe	Px--sa
radi	raditi	Vmr3s
o	o	Sl
posebnom	poseban	Agpnsly
upravnom	upravan	Agpnsly
području	područje	Ncnsl
koje	koji	Pi-nsa
s	sa	Si
obzirom	obzir	Ncmsi
na	na	Sa
svoju	svoj	Px-fsa
složenost	složenost	Ncfsa
traži	tražiti	Vmr3s
povezivanje	povezivanje	Ncnsa
s	sa	Si
odgovarajućim	odgovarajući	Agpmpiy
člancima	članak	Ncmpi
konkretne	konkretan	Agpfsgy
standardne	standardan	Agpfsgy
ponude	ponuda	Ncfsg
tužitelja	tužitelj	Ncmsg
.	.	Z

Sud	sud	Ncmsn
s	sa	Si
tim	taj	Pd-nsi
u	u	Sl
vezi	veza	Ncfsl
ocjenjuje	ocjenjivati	Vmr3s
da	da	Cs
je	biti	Var3s
izreka	izreka	Ncfsn
odrediva	odrediv	Agpfsny
,	,	Z
jer	jer	Cs
su	biti	Var3p
u	u	Sl
njoj	on	Pp3fsl
navedeni	navesti	Appmpny
odgovarajući	odgovarajući	Agpmpny
parametri	parametar	Ncmpn
koji	koji	Pi-mpn
čine	činiti	Vmr3p
dostatnu	dostatan	Agpfsay
osnovu	osnova	Ncfsa
temeljem	temelj	Ncmsi
koje	koji	Pi-fpn
se	sebe	Px--sa
obveza	obveza	Ncfsn
može	moći	Vmr3s
bez	bez	Sg
teškoća	teškoća	Ncfpg
utvrditi	utvrditi	Vmn
.	.	Z

U	u	Sl
odnosu	odnos	Ncmsl
na	na	Sa
prigovore	prigovor	Ncmpa
kojim	koji	Pi-msi
tužitelj	tužitelj	Ncmsn
osporava	osporavati	Vmr3s
opravdanost	opravdanost	Ncfsa
naknada	naknada	Ncfpg
za	za	Sa
kašnjenje	kašnjenje	Ncnsa
u	u	Sl
otklanjanju	otklanjanje	Ncnsl
kvarova	kvar	Ncmpg
/	/	Z
smetnji	smetnja	Ncfpg
za	za	Sa
uslugu	usluga	Ncfsa
izdvojenog	izdvojiti	Agpmsgy
pristupa	pristup	Ncmsg
lokalnoj	lokalan	Agpfsly
petlji	petlja	Ncfsl
,	,	Z
Sud	sud	Ncmsn
upućuje	upućivati	Vmr3s
na	na	Sa
obrazloženje	obrazloženje	Ncnsa
osporenog	osporiti	Agpnsgy
rješenja	rješenje	Ncnsg
koje	koji	Pi-nsn
je	biti	Var3s
iscrpno	iscrpan	Agpnsny
i	i	Cc
valjano	valjano	Rgp
obrazloženo	obrazložiti	Appnsny
glede	glede	Sg
izostanka	izostanak	Ncmsg
aktivne	aktivan	Agpfsgy
suradnje	suradnja	Ncfsg
tužitelja	tužitelj	Ncmsg
sa	sa	Si
zainteresiranom	zainteresiran	Agpfsiy
osobom	osoba	Ncfsi
po	po	Sl
tom	taj	Pd-nsl
pitanju	pitanje	Ncnsl
,	,	Z
što	što	Pi3n-n
je	biti	Var3s
ovdje	ovdje	Rgp
upravo	upravo	Rgp
i	i	Qo
osnova	osnova	Ncfsn
za	za	Sa
određivanje	određivanje	Ncnsa
naknade	naknada	Ncfsg
.	.	Z

Slijedom	slijed	Ncmsi
naprijed	naprijed	Rgp
izloženog	izložen	Agpnsgy
proizlazi	proizlaziti	Vmr3s
da	da	Cs
je	biti	Var3s
osporeno	osporiti	Agpnsny
rješenje	rješenje	Ncnsn
valjano	valjati	Appnsny
obrazloženo	obrazložiti	Appnsny
te	te	Cc
utemeljeno	utemeljiti	Appnsny
na	na	Sl
mjerodavnim	mjerodavan	Agpfply
odredbama	odredba	Ncfpl
materijalnog	materijalan	Agpnsgy
prava	pravo	Ncnsg
,	,	Z
pa	pa	Cc
obzirom	obzir	Ncmsi
da	da	Cs
navodima	navod	Ncmpi
istaknutim	istaknuti	Appmply
u	u	Sl
tužbi	tužba	Ncfsl
tužitelj	tužitelj	Ncmsn
nije	biti	Var3s
doveo	dovesti	Vmp-sm
u	u	Sa
pitanje	pitanje	Ncnsa
zakonitost	zakonitost	Ncfsa
tog	taj	Pd-nsg
rješenja	rješenje	Ncnsg
Sud	sud	Ncmsn
je	biti	Var3s
tužbu	tužba	Ncfsa
odbio	odbiti	Vmp-sm
temeljem	temelj	Ncmsi
članka	članak	Ncmsg
57.	57.	Mdo
stavka	stavak	Ncmsg
1.	1.	Mdo
ZUS-a	ZUS	Npmsg
.	.	Z

Objava	objava	Ncfsn
presude	presuda	Ncfsg
temelji	temeljiti	Vmr3s
se	sebe	Px--sa
na	na	Sl
odredbi	odredba	Ncfsl
članka	članak	Ncmsg
14.	14.	Mdo
stavka	stavak	Ncmsg
8.	8.	Mdo
ZEK-a	ZEK	Npmsg
.	.	Z

Poslovni	poslovan	Agpmsny
broj	broj	Ncmsn
:	:	Z
UsII-105	UsII-105	Mds
/	/	Z
13	13	Mdc
-	-	Z
6	6	Mdc
Zagreb	Zagreb	Npmsn
,	,	Z
27.	27.	Mdo
kolovoza	kolovoz	Ncmsg
2015.	2015.	Mdo

Predsjednica	predsjednica	Ncfsn
vijeća	vijeće	Ncnsg
Sanja	Sanja	Npfsn
Štefan	Štefan	Npmsn
,	,	Z
v.	v.	Y
r.	r.	Y

