12	12	Mdc
02.02.2015	02.02.2015	Mdo
Naredba	naredba	Ncfsn
o	o	Sl
načinu	način	Ncmsl
uplaćivanja	uplaćivanje	Ncnsg
prihoda	prihod	Ncmpg
proračuna	proračun	Ncmsg
,	,	Z
obveznih	obvezan	Agpmpgy
doprinosa	doprinos	Ncmpg
te	te	Cc
prihoda	prihod	Ncmpg
za	za	Sa
financiranje	financiranje	Ncnsa
drugih	drugi	Mlofpg
javnih	javan	Agpfpgy
potreba	potreba	Ncfpg
u	u	Sl
2015.	2015.	Mdo
godini	godina	Ncfsl

MINISTARSTVO	ministarstvo	Ncnsn
FINANCIJA	financije	Ncfpg

237	237	Mdc

Na	na	Sl
temelju	temelj	Ncmsl
članka	članak	Ncmsg
22.	22.	Mdo

Zakona	zakon	Ncmsg
o	o	Sl
izvršavanju	izvršavanje	Ncnsl
Državnog	državni	Agpmsgy
proračuna	proračun	Ncmsg
Republike	republika	Ncfsg
Hrvatske	Hrvatska	Npfsg
za	za	Sa
2015.	2015.	Mdo
godinu	godina	Ncfsa
(	(	Z
»	»	Z
Narodne	narodni	Agpfpny
novine	novina	Ncfpn
«	«	Z
,	,	Z
broj	broj	Ncmsn
148/14	148/14	Mds
)	)	Z
ministar	ministar	Ncmsn
financija	financije	Ncfpg
donosi	donositi	Vmr3s

NAREDBU	naredba	Ncfsa
O	o	Sl
NAČINU	način	Ncmsl
UPLAĆIVANJA	uplaćivanje	Ncnsg
PRIHODA	prihod	Ncmpg
PRORAČUNA	proračun	Ncmsg
,	,	Z
OBVEZNIH	obvezan	Agpmpgy
DOPRINOSA	doprinos	Ncmpg
TE	te	Cc
PRIHODA	prihod	Ncmpg
ZA	za	Sa
FINANCIRANJE	financiranje	Ncnsa
DRUGIH	drugi	Mlofpg
JAVNIH	javan	Agpfpgy
POTREBA	potreba	Ncfpg
U	u	Sl
2015.	2015.	Mdo

GODINI	godina	Ncfsl

