130	130	Mdc
30.11.2015	30.11.2015	Mdo
Ispravak	ispravak	Ncmsn
Odluke	odluka	Ncfsg
o	o	Sl
privremenom	privremen	Agpnsly
financiranju	financiranje	Ncnsl
poslova	posao	Ncmpg
,	,	Z
funkcija	funkcija	Ncfpg
i	i	Cc
programa	program	Ncmpg
državnih	državni	Agpnpgy
tijela	tijelo	Ncnpg
i	i	Cc
drugih	drugi	Mlompg
proračunskih	proračunski	Agpmpgy
korisnika	korisnik	Ncmpg
državnog	državni	Agpmsgy
proračuna	proračun	Ncmsg
Republike	republika	Ncfsg
Hrvatske	Hrvatska	Npfsg
u	u	Sl
prvom	prvi	Mlonsl
tromjesečju	tromjesečje	Ncnsl
2016.	2016.	Mdo
godine	godina	Ncfsg

HRVATSKI	hrvatski	Agpmsny
SABOR	sabor	Ncmsn

2472	2472	Mdc

Nakon	nakon	Sg
izvršenog	izvršen	Agpnsgy
uspoređivanja	uspoređivanje	Ncnsg
s	sa	Si
izvornim	izvoran	Agpmsiy
tekstom	tekst	Ncmsi
utvrđena	utvrditi	Appfsny
je	biti	Var3s
pogreška	pogreška	Ncfsn
u	u	Sl
Odluci	odluka	Ncfsl
o	o	Sl
privremenom	privremen	Agpnsly
financiranju	financiranje	Ncnsl
poslova	posao	Ncmpg
,	,	Z
funkcija	funkcija	Ncfpg
i	i	Cc
programa	program	Ncmpg
državnih	državni	Agpnpgy
tijela	tijelo	Ncnpg
i	i	Cc
drugih	drugi	Mlompg
proračunskih	proračunski	Agpmpgy
korisnika	korisnik	Ncmpg
državnog	državni	Agpmsgy
proračuna	proračun	Ncmsg
Republike	republika	Ncfsg
Hrvatske	Hrvatska	Npfsg
u	u	Sl
prvom	prvi	Mlonsl
tromjesečju	tromjesečje	Ncnsl
2016.	2016.	Mdo
godine	godina	Ncfsg
,	,	Z
koja	koji	Pi-fsn
je	biti	Var3s
objavljena	objaviti	Appfsny
u	u	Sl
»	»	Z
Narodnim	narodni	Agpfply
novinama	novina	Ncfpl
«	«	Z
broj	broj	Ncmsn
109	109	Mdc
od	od	Sg
12.	12.	Mdo
listopada	listopad	Ncmsg
2015.	2015.	Mdo
te	te	Cc
se	sebe	Px--sa
daje	davati	Vmr3s

ISPRAVAK	ispravak	Ncmsn

ODLUKE	odluka	Ncfpa
O	o	Sl
PRIVREMENOM	privremen	Agpnsly
FINANCIRANJU	financiranje	Ncnsl
POSLOVA	posao	Ncmpg
,	,	Z
FUNKCIJA	funkcija	Ncfsn
I	i	Cc
PROGRAMA	program	Ncmpg
DRŽAVNIH	državni	Agpnpgy
TIJELA	tijelo	Ncnpg
I	i	Cc
DRUGIH	drugi	Mlompg
PRORAČUNSKIH	proračunski	Agpmpgy
KORISNIKA	korisnik	Ncmpg
DRŽAVNOG	državni	Agpmsgy
PRORAČUNA	proračun	Ncmsg
REPUBLIKE	republika	Ncfsg
HRVATSKE	Hrvatska	Npfsg
U	u	Sl
PRVOM	prvi	Mlonsl
TROMJESEČJU	tromjesečje	Ncnsl
2016.	2016.	Mdo

GODINE	godina	Ncfsg

U	u	Sl
Posebnom	poseban	Agpmsly
dijelu	dio	Ncmsl
u	u	Sl
točki	točka	Ncfsl
III	III	Mrc
.	.	Z
unutar	unutar	Sg
razdjela	razdjel	Ncmsg
025	025	Mdc
MINISTARSTVO	ministarstvo	Ncnsn
FINANCIJA	financije	Ncfpg
,	,	Z
glave	glava	Ncfsg
02506	02506	Mdc
Ministarstvo	ministarstvo	Ncnsn
financija	financije	Ncfpg
–	–	Z
ostali	ostali	Agpmpny
izdaci	izdatak	Ncmpn
države	država	Ncfsg
,	,	Z
programa	program	Ncmsg
22	22	Mdc
FINANCIJSKI	financijski	Agpmpny
I	i	Cc
FISKALNI	fiskalan	Agpmsayn
SUSTAV	sustav	Ncmsan
,	,	Z
programi	program	Ncmpn
2204	2204	Mdc
FINANCIRANJE	financiranje	Ncnsa
DECENTRALIZIRANIH	decentraliziran	Agpfpgy
FUNKCIJA	funkcija	Ncfpg
i	i	Cc
2205	2205	Mdc
POMOĆI	pomoć	Ncfsg
LOKALNOJ	lokalan	Agpfsly
I	i	Cc
PODRUČNOJ	područni	Agpfsly
(	(	Z
REGIONALNOJ	regionalan	Agpfsly
)	)	Z
SAMOUPRAVI	samouprava	Ncfsl
te	te	Cc
sve	sav	Agpfpay
pripadajuće	pripadajući	Agpfpay
aktivnosti	aktivnost	Ncfpa
trebaju	trebati	Vmr3p
glasiti	glasiti	Vmn
:	:	Z

TABLICA	tablica	Ncfsn

Klasa	klasa	Ncfsn
:	:	Z
400	400	Mdc
-	-	Z
06/15	06/15	Mdc
-	-	Z
02/32	02/32	Mdc

Zagreb	Zagreb	Npmsn
,	,	Z
22.	22.	Mdo
studenoga	studeni	Ncmsg
2015.	2015.	Mdo

Tajnica	tajnica	Ncfsn
Hrvatskoga	hrvatski	Agpmsgy
sabora	sabor	Ncmsg
dr.	dr.	Y
sc.	sc.	Y
Lidija	Lidija	Npfsn
Bagarić	Bagarić	Npfsn
,	,	Z
v.	v.	Y
r.	r.	Y

