čuvanje	čuvanje	Ncnsn
i	i	Cc
osiguravanje	osiguravanje	Ncnsa
dostupnosti	dostupnost	Ncfsg
dokumentacije	dokumentacija	Ncfsg
vezane	vezan	Agpfsgy
uz	uz	Sa
izdatke	izdatak	Ncmpa
za	za	Sa
koje	koji	Pi-mpa
je	biti	Var3s
korisniku	korisnik	Ncmsd
isplaćena	isplatiti	Appfsny
potpora	potpora	Ncfsn
iz	iz	Sg
Europskog	europski	Agpmsgy
fonda	fond	Ncmsg
za	za	Sa
pomorstvo	pomorstvo	Ncnsa
najmanje	malo	Rgs
dvije	dva	Mlcf-n
godine	godina	Ncfsg
od	od	Sg
31.	31.	Mdo
prosinca	prosinac	Ncmsg
nakon	nakon	Sg
predaje	predaja	Ncfsg
računa	račun	Ncmpg
u	u	Sl
kojima	koji	Pi-fpl
su	biti	Var3p
uključeni	uključiti	Appmpny
završni	završan	Agpmpny
izdaci	izdatak	Ncmpn
operacije	operacija	Ncfsg
.	.	Z

Također	također	Rgp
,	,	Z
korisnik	korisnik	Ncmsn
je	biti	Var3s
dužan	dužan	Agpmsnn
dokumentaciju	dokumentacija	Ncfsa
čuvati	čuvati	Vmn
i	i	Cc
osigurati	osigurati	Vmn
dostupnost	dostupnost	Ncfsa
iste	isti	Agpfsgy
tijekom	tijekom	Sg
cjelokupnog	cjelokupan	Agpnsgy
razdoblja	razdoblje	Ncnsg
provođenja	provođenje	Ncnsg
operacije	operacija	Ncfsg
.	.	Z

