141	141	Mdc
31.12.2015	31.12.2015	Mdo
Odluka	odluka	Ncfsn
o	o	Sl
izboru	izbor	Ncmsl
predsjednice	predsjednica	Ncfsg
,	,	Z
potpredsjednice	potpredsjednica	Ncfsg
i	i	Cc
članova	član	Ncmpg
Mandatno-imunitetnog	mandatno-imunitetni	Agpnsgy
povjerenstva	povjerenstvo	Ncnsg
Hrvatskoga	hrvatski	Agpmsgy
sabora	sabor	Ncmsg

HRVATSKI	hrvatski	Agpmsny
SABOR	sabor	Ncmsn

2629	2629	Mdc

Na	na	Sl
temelju	temelj	Ncmsl
članka	članak	Ncmsg
81.	81.	Mdo

Ustava	ustava	Ncfsn
Republike	republika	Ncfsg
Hrvatske	Hrvatska	Npfsg
i	i	Cc
članka	članak	Ncmsg
5.	5.	Mdo
i	i	Cc
117.	117.	Mdo

Poslovnika	poslovnik	Ncmsg
Hrvatskoga	hrvatski	Agpmsgy
sabora	sabor	Ncmsg
,	,	Z
Hrvatski	hrvatski	Agpmsny
sabor	sabor	Ncmsn
na	na	Sl
sjednici	sjednica	Ncfsl
28.	28.	Mdo
prosinca	prosinac	Ncmsg
2015.	2015.	Mdo
donio	donijeti	Vmp-sm
je	biti	Var3s

ODLUKU	odluka	Ncfsa

O	o	Sl
IZBORU	izbor	Ncmsl
PREDSJEDNICE	predsjednica	Ncfsg
,	,	Z
POTPREDSJEDNICE	potpredsjednica	Ncfsg
I	i	Cc
ČLANOVA	član	Ncmpg
MANDATNO-IMUNITETNOG	mandatno-imunitetni	Agpnsgy
POVJERENSTVA	povjerenstvo	Ncnsg
HRVATSKOGA	hrvatski	Agpmsgy
SABORA	sabor	Ncmsg

U	u	Sa
Mandatno-imunitetno	mandatno-imunitetni	Agpnsay
povjerenstvo	povjerenstvo	Ncnsa
Hrvatskoga	hrvatski	Agpmsgy
sabora	sabor	Ncmsg
biraju	birati	Vmr3p
se	sebe	Px--sa
:	:	Z

–	i	Agpnsny
za	za	Sa
predsjednicu	predsjednica	Ncfsa

MARGARETA	Margareta	Npfsn
MAĐERIĆ	MAĐERIĆ	Npfsn

–	i	Agpnsny
za	za	Sa
potpredsjednicu	potpredsjednica	Ncfsa

GORDANA	GORDANA	Npfsn
SOBOL	sobol	Ncmsn

–	i	Agpfpny
za	za	Sa
članove	član	Ncmpa
:	:	Z

DRAŽEN	dražiti	Appmsnn
BOŠNJAKOVIĆ	BOŠNJAKOVIĆ	Npmsn

DARIO	DARIO	Npmsn
HREBAK	HREBAK	Npmsn

JURO	JURO	Npmsn
MARTINOVIĆ	Martinović	Npmsn

MIROSLAV	MIROSLAV	Npmsn
ŠIMIĆ	Šimić	Npmsn

SAŠA	Saša	Npmsn
ĐUJIĆ	ĐUJIĆ	Npmsn

ALEN	ALEN	Npmsn
PRELEC	PRELEC	Npmsn

NADA	Nada	Npfsn
TURINA	TURINA	Npfsn
ĐURIĆ	Đurić	Npfsn
.	.	Z

Klasa	klasa	Ncfsn
:	:	Z
021	021	Mdc
-	-	Z
13/15	13/15	Mdc
-	-	Z
03/01	03/01	Mdc

Zagreb	Zagreb	Npmsn
,	,	Z
28.	28.	Mdo
prosinca	prosinac	Ncmsg
2015.	2015.	Mdo

HRVATSKI	hrvatski	Agpmsny
SABOR	sabor	Ncmsn

Predsjednik	predsjednik	Ncmsn
Hrvatskoga	hrvatski	Agpmsgy
sabora	sabor	Ncmsg
akademik	akademik	Ncmsn
Željko	Željko	Npmsn
Reiner	Reiner	Npmsn
,	,	Z
v.	v.	Y
r.	r.	Y

