o	o	Sl
položenom	položiti	Agpmsly
ispitu	ispit	Ncmsl
za	za	Sa
ovlaštenog	ovlašten	Agpmsayy
mjeritelja	mjeritelj	Ncmsay

____________________________________________________________________________________________________	___________________________________________________________________________________________________i	Agpnsny
(	(	Z
ime	ime	Ncnsa
i	i	Cc
prezime	prezime	Ncnsa
kandidata	kandidat	Ncmpg
,	,	Z
stečeno	steći	Agpnsny
obrazovanje	obrazovanje	Ncnsn
)	)	Z

____________________________________________________________________________________________________	____________________________________________________________________________________________________	Npmsn
,	,	Z
(	(	Z
mjesto	mjesto	Ncnsn
i	i	Cc
datum	datum	Ncmsn
rođenja	rođenje	Ncnsg
)	)	Z

broj	broj	Ncmsn
osobne	osoban	Agpfsgy
iskaznice	iskaznica	Ncfsg
___________________	___________________	Z
,	,	Z
mjesto	mjesto	Ncnsa
izdavanja	izdavanje	Ncnsg
__________________________________________________	_________________________________________________i	Agpnsny
,	,	Z

položio	položiti	Vmp-sm
/	/	Z
položila	položiti	Vmp-sf
je	biti	Var3s
dana	dan	Agpfsny
________________________________	________________________________	Ncfsn
(	(	Z
datum	datum	Ncmsn
)	)	Z

ispit	ispit	Ncmsn
u	u	Sl
području	područje	Ncnsl
____________________________________________________	____________________________________________________	Z

Ovo	ovaj	Pd-nsn
Uvjerenje	uvjerenje	Ncnsn
vrijedi	vrijediti	Vmr3s
do	do	Sg
_____________________________________________	____________________________________________	Ncmsg
(	(	Z
datum	datum	Ncmsn
)	)	Z

Klasa	klasa	Ncfsn
:	:	Z

Urbroj	urbroj	Ncmsn
:	:	Z

Zagreb	Zagreb	Npmsn
,	,	Z

Predsjednik	predsjednik	Ncmsn
Ravnatelj	ravnatelj	Ncmsn
Povjerenstva	povjerenstvo	Ncnsg
:	:	Z

______________________	______________________	I
____________________	____________________	Z

PRILOG	prilog	Ncmsn
3.	3.	Mdo

OBRAZAC	obrazac	Ncmsn
SLUŽBENE	služben	Agpfsgy
ISKAZNICE	iskaznica	Ncfsg
OVLAŠTENOG	ovlašten	Agpmsgy
MJERITELJA	mjeritelj	Ncmsg

