9	9	Mdc
27.01.2016	27.01.2016	Mdo
Odluka	odluka	Ncfsn
o	o	Sl
izboru	izbor	Ncmsl
predsjednika	predsjednik	Ncmsg
,	,	Z
potpredsjednika	potpredsjednik	Ncmpg
i	i	Cc
članova	član	Ncmpg
Odbora	odbor	Ncmsg
za	za	Sa
pomorstvo	pomorstvo	Ncnsa
,	,	Z
promet	promet	Ncmsan
i	i	Cc
infrastrukturu	infrastruktura	Ncfsa
Hrvatskoga	hrvatski	Agpmsgy
sabora	sabor	Ncmsg

HRVATSKI	hrvatski	Agpmsny
SABOR	sabor	Ncmsn

204	204	Mdc

Na	na	Sl
temelju	temelj	Ncmsl
članka	članak	Ncmsg
81.	81.	Mdo

Ustava	ustava	Ncfsn
Republike	republika	Ncfsg
Hrvatske	Hrvatska	Npfsg
i	i	Cc
članaka	članak	Ncmpg
46.	46.	Mdo
i	i	Cc
104.	104.	Mdo

Poslovnika	poslovnik	Ncmsg
Hrvatskoga	hrvatski	Agpmsgy
sabora	sabor	Ncmsg
,	,	Z
Hrvatski	hrvatski	Agpmsny
sabor	sabor	Ncmsn
na	na	Sl
sjednici	sjednica	Ncfsl
23.	23.	Mdo
siječnja	siječanj	Ncmsg
2016.	2016.	Mdo
donio	donijeti	Vmp-sm
je	biti	Var3s

ODLUKU	odluka	Ncfsa

O	o	Sl
IZBORU	izbor	Ncmsl
PREDSJEDNIKA	predsjednik	Ncmsg
,	,	Z
POTPREDSJEDNIKA	potpredsjednik	Ncmpg
I	i	Cc
ČLANOVA	član	Ncmpg
ODBORA	odbor	Ncmsg
ZA	za	Sa
POMORSTVO	pomorstvo	Ncnsa
,	,	Z
PROMET	promet	Ncmsan
I	i	Cc
INFRASTRUKTURU	infrastruktura	Ncfsa
HRVATSKOGA	hrvatski	Agpmsgy
SABORA	sabor	Ncmsg

U	u	Sa
Odbor	odbor	Ncmsan
za	za	Sa
pomorstvo	pomorstvo	Ncnsa
,	,	Z
promet	promet	Ncmsan
i	i	Cc
infrastrukturu	infrastruktura	Ncfsa
Hrvatskoga	hrvatski	Agpmsgy
sabora	sabor	Ncmsg
biraju	birati	Vmr3p
se	sebe	Px--sa
:	:	Z

za	za	Sa
predsjednika	predsjednik	Ncmsay

PERO	pero	Ncnsn
ĆOSIĆ	ĆOSIĆ	Npfsg

za	za	Sa
potpredsjednika	potpredsjednik	Ncmsay

VEDRAN	VEDRAN	Npmsn
BABIĆ	Babić	Npmsn

za	za	Sa
članove	član	Ncmpa

BRANKO	Branko	Npmsn
BAČIĆ	BAČIĆ	Npmsn

DOMAGOJ	domagoj	Agpmsny
IVAN	Ivan	Npmsn
MILOŠEVIĆ	Milošević	Npmsn

PETAR	PETAR	Npmsn
ŠKORIĆ	Škorić	Npmsn

BOŽIDAR	BOŽIDAR	Npmsn
KALMETA	kalmeta	Ncfsn

IVAN	Ivan	Npmsn
KOVAČIĆ	Kovačić	Npmsn

MIRO	Miro	Npmsn
BULJ	BULJ	Npmsn

DARKO	Darko	Npmsn
PARIĆ	PARIĆ	Npmsn

TOMISLAV	TOMISLAV	Npmsn
ŽAGAR	ŽAGAR	Npmsn

NADA	Nada	Npfsn
TURINA-ĐURIĆ	TURINA-ĐURIĆ	Npfsn

SILVANO	silvani	Agpnsny
HRELJA	hrelja	Ncnsn
.	.	Z

Klasa	klasa	Ncfsn
:	:	Z
021	021	Mdc
-	-	Z
13/16	13/16	Mdc
-	-	Z
03/24	03/24	Mdc

Zagreb	Zagreb	Npmsn
,	,	Z
23.	23.	Mdo
siječnja	siječanj	Ncmsg
2016.	2016.	Mdo

HRVATSKI	hrvatski	Agpmsny
SABOR	sabor	Ncmsn

Predsjednik	predsjednik	Ncmsn
Hrvatskoga	hrvatski	Agpmsgy
sabora	sabor	Ncmsg
akademik	akademik	Ncmsn
Željko	Željko	Npmsn
Reiner	Reiner	Npmsn
,	,	Z
v.	v.	Y
r.	r.	Y

