9	9	Mdc
27.01.2016	27.01.2016	Mdo
Odluka	odluka	Ncfsn
o	o	Sl
imenovanju	imenovanje	Ncnsl
Izaslanstva	izaslanstvo	Ncnsg
Hrvatskoga	hrvatski	Agpmsgy
sabora	sabor	Ncmsg
u	u	Sl
Parlamentarnoj	parlamentaran	Agpfsly
skupštini	skupština	Ncfsl
Vijeća	vijeće	Ncnsg
Europe	Europa	Npfsg

HRVATSKI	hrvatski	Agpmsny
SABOR	sabor	Ncmsn

213	213	Mdc

Na	na	Sl
temelju	temelj	Ncmsl
članka	članak	Ncmsg
81.	81.	Mdo

Ustava	ustava	Ncfsn
Republike	republika	Ncfsg
Hrvatske	Hrvatska	Npfsg
,	,	Z
Hrvatski	hrvatski	Agpmsny
sabor	sabor	Ncmsn
na	na	Sl
sjednici	sjednica	Ncfsl
23.	23.	Mdo
siječnja	siječanj	Ncmsg
2016.	2016.	Mdo
donio	donijeti	Vmp-sm
je	biti	Var3s

ODLUKU	odluka	Ncfsa

O	o	Sl
IMENOVANJU	imenovanje	Ncnsl
IZASLANSTVA	izaslanstvo	Ncnsg
HRVATSKOGA	hrvatski	Agpmsgy
SABORA	sabor	Ncmsg
U	u	Sl
PARLAMENTARNOJ	parlamentaran	Agpfsly
SKUPŠTINI	skupština	Ncfsl
VIJEĆA	vijeće	Ncnsg
EUROPE	Europa	Npfsg

U	u	Sa
Izaslanstvo	izaslanstvo	Ncnsa
Hrvatskoga	hrvatski	Agpmsgy
sabora	sabor	Ncmsg
u	u	Sl
Parlamentarnoj	parlamentaran	Agpfsly
skupštini	skupština	Ncfsl
Vijeća	vijeće	Ncnsg
Europe	Europa	Npfsg
imenuju	imenovati	Vmr3p
se	sebe	Px--sa
:	:	Z

za	za	Sa
voditelja	voditelj	Ncmsay

JASEN	JASEN	Npmsn
MESIĆ	Mesić	Npmsn

za	za	Sa
članove	član	Ncmpa

GORDAN	GORDAN	Npmsn
JANDROKOVIĆ	Jandroković	Npmsn

SANDRA	Sandra	Npfsn
JAKELIĆ	JAKELIĆ	Npfsn

za	za	Sa
zamjenike	zamjenik	Ncmpa
članova	član	Ncmpg

JOSIP	Josip	Npmsn
BILAVER	BILAVER	Npmsn

JOSIPA	JOSIPA	Npfsn
RIMAC	RIMAC	Npfsn
.	.	Z

Klasa	klasa	Ncfsn
:	:	Z
021	021	Mdc
-	-	Z
13/16	13/16	Mdc
-	-	Z
04/03	04/03	Mdc

Zagreb	Zagreb	Npmsn
,	,	Z
23.	23.	Mdo
siječnja	siječanj	Ncmsg
2016.	2016.	Mdo

HRVATSKI	hrvatski	Agpmsny
SABOR	sabor	Ncmsn

Predsjednik	predsjednik	Ncmsn
Hrvatskoga	hrvatski	Agpmsgy
sabora	sabor	Ncmsg
akademik	akademik	Ncmsn
Željko	Željko	Npmsn
Reiner	Reiner	Npmsn
,	,	Z
v.	v.	Y
r.	r.	Y

