21	21	Mdc
09.03.2016	09.03.2016	Mdo
Odluka	odluka	Ncfsn
o	o	Sl
imenovanju	imenovanje	Ncnsl
vršitelja	vršitelj	Ncmsg
dužnosti	dužnost	Ncfsg
Glavnog	glavni	Agpmsgy
ravnatelja	ravnatelj	Ncmsg
Hrvatske	hrvatski	Agpfsgy
radiotelevizije	radiotelevizija	Ncfsg

HRVATSKI	hrvatski	Agpmsny
SABOR	sabor	Ncmsn

588	588	Mdc

Na	na	Sl
temelju	temelj	Ncmsl
članka	članak	Ncmsg
81.	81.	Mdo

Ustava	ustava	Ncfsn
Republike	republika	Ncfsg
Hrvatske	Hrvatska	Npfsg
i	i	Cc
članka	članak	Ncmsg
19.	19.	Mdo
a	a	Cc
stavka	stavka	Ncfsn
4.	4.	Mdo
Zakona	zakon	Ncmsg
o	o	Sl
Hrvatskoj	Hrvatska	Npfsl
radioteleviziji	radiotelevizija	Ncfsl
(	(	Z
»	»	Z
Narodne	narodni	Agpfpny
novine	novina	Ncfpn
«	«	Z
,	,	Z
br.	br.	Y
137/10.	137/10.	Mds
i	i	Cc
76/12.	76/12.	Mdo
)	)	Z
Hrvatski	hrvatski	Agpmsny
sabor	sabor	Ncmsn
na	na	Sl
sjednici	sjednica	Ncfsl
4.	4.	Mdo
ožujka	ožujak	Ncmsg
2016.	2016.	Mdo
donio	donijeti	Vmp-sm
je	biti	Var3s

ODLUKU	odluka	Ncfsa

O	o	Sl
IMENOVANJU	imenovanje	Ncnsl
VRŠITELJA	vršitelj	Ncmpg
DUŽNOSTI	dužnost	Ncfsg
GLAVNOG	glavni	Agpmsgy
RAVNATELJA	ravnatelj	Ncmsg
HRVATSKE	hrvatski	Agpfsgy
RADIOTELEVIZIJE	radiotelevizija	Ncfsg

Za	za	Sa
vršitelja	vršitelj	Ncmsay
dužnosti	dužnost	Ncfsg
Glavnog	glavni	Agpmsgy
ravnatelja	ravnatelj	Ncmsg
Hrvatske	hrvatski	Agpfsgy
radiotelevizije	radiotelevizija	Ncfsg
imenuje	imenovati	Vmr3s
se	sebe	Px--sa
SINIŠA	SINIŠA	Npmsn
KOVAČIĆ	Kovačić	Npmsn
.	.	Z

Klasa	klasa	Ncfsn
:	:	Z
021	021	Mdc
-	-	Z
13/16	13/16	Mdc
-	-	Z
07/16	07/16	Mdc

Zagreb	Zagreb	Npmsn
,	,	Z
4.	4.	Mdo
ožujka	ožujak	Ncmsg
2016.	2016.	Mdo

HRVATSKI	hrvatski	Agpmsny
SABOR	sabor	Ncmsn

Predsjednik	predsjednik	Ncmsn
Hrvatskoga	hrvatski	Agpmsgy
sabora	sabor	Ncmsg
akademik	akademik	Ncmsn
Željko	Željko	Npmsn
Reiner	Reiner	Npmsn
,	,	Z
v.	v.	Y
r.	r.	Y

