24	24	Mdc
18.03.2016	18.03.2016	Mdo
Odluka	odluka	Ncfsn
o	o	Sl
razrješenju	razrješenje	Ncnsl
člana	član	Ncmsg
Upravnog	upravan	Agpnsgy
vijeća	vijeće	Ncnsg
Hrvatske	hrvatski	Agpfsgy
energetske	energetski	Agpfsgy
regulatorne	regulatoran	Agpfsgy
agencije	agencija	Ncfsg

HRVATSKI	hrvatski	Agpmsny
SABOR	sabor	Ncmsn

663	663	Mdc

Na	na	Sl
temelju	temelj	Ncmsl
članka	članak	Ncmsg
81.	81.	Mdo

Ustava	ustava	Ncfsn
Republike	republika	Ncfsg
Hrvatske	Hrvatska	Npfsg
i	i	Cc
članka	članak	Ncmsg
26.	26.	Mdo
stavka	stavak	Ncmsg
2.	2.	Mdo
točke	točka	Ncfsg
1.	1.	Mdo
Zakona	zakon	Ncmsg
o	o	Sl
regulaciji	regulacija	Ncfsl
energetskih	energetski	Agpfpgy
djelatnosti	djelatnost	Ncfpg
(	(	Z
»	»	Z
Narodne	narodni	Agpfpny
novine	novina	Ncfpn
«	«	Z
,	,	Z
br.	br.	Y
120/12.	120/12.	Mdo
)	)	Z
Hrvatski	hrvatski	Agpmsny
sabor	sabor	Ncmsn
na	na	Sl
sjednici	sjednica	Ncfsl
11.	11.	Mdo
ožujka	ožujak	Ncmsg
2016.	2016.	Mdo
donio	donijeti	Vmp-sm
je	biti	Var3s

ODLUKU	odluka	Ncfsa

O	o	Sl
RAZRJEŠENJU	razrješenje	Ncnsl
ČLANA	član	Ncmsg
UPRAVNOG	upravan	Agpnsgy
VIJEĆA	vijeće	Ncnsg
HRVATSKE	hrvatski	Agpfsgy
ENERGETSKE	energetski	Agpfsgy
REGULATORNE	regulatoran	Agpfsgy
AGENCIJE	agencija	Ncfsg

Razrješuje	razrješivati	Vmr3s
se	sebe	Px--sa
ZDESLAV	ZDESLAV	Npmsn
MATIĆ	Matić	Npmsn
dužnosti	dužnost	Ncfsg
člana	član	Ncmsg
Upravnog	upravan	Agpnsgy
vijeća	vijeće	Ncnsg
Hrvatske	hrvatski	Agpfsgy
energetske	energetski	Agpfsgy
regulatorne	regulatoran	Agpfsgy
agencije	agencija	Ncfsg
,	,	Z
s	sa	Si
danom	dan	Ncmsi
11.	11.	Mdo
veljače	veljača	Ncfsg
2016.	2016.	Mdo
,	,	Z
na	na	Sa
osobni	osoban	Agpmsayn
zahtjev	zahtjev	Ncmsan
.	.	Z

Klasa	klasa	Ncfsn
:	:	Z
021	021	Mdc
-	-	Z
13/16	13/16	Mdc
-	-	Z
07/09	07/09	Mdc

Zagreb	Zagreb	Npmsn
,	,	Z
11.	11.	Mdo
ožujka	ožujak	Ncmsg
2016.	2016.	Mdo

HRVATSKI	hrvatski	Agpmsny
SABOR	sabor	Ncmsn

Predsjednik	predsjednik	Ncmsn
Hrvatskoga	hrvatski	Agpmsgy
sabora	sabor	Ncmsg
akademik	akademik	Ncmsn
Željko	Željko	Npmsn
Reiner	Reiner	Npmsn
,	,	Z
v.	v.	Y
r.	r.	Y

