eurocenta	eurocent	Ncmsg
po	po	Sl
prijenosu	prijenos	Ncmsl

Članak	članak	Ncmsn
2.	2.	Mdo

Ova	ovaj	Pd-fsn
Odluka	odluka	Ncfsn
objavljuje	objavljivati	Vmr3s
se	sebe	Px--sa
u	u	Sl
»		Agpfply
Narodnim	narodni	Agpfply
novinama	novina	Ncfpl
«	«	Z
i	i	Cc
stupa	stupati	Vmr3s
na	na	Sa
snagu	snaga	Ncfsa
15.	15.	Mdo
travnja	travanj	Ncmsg
2016.	2016.	Mdo

O.	O.	Y
br.	br.	Y
815/2016.	815/2016.	Mds

Zagreb	Zagreb	Npmsn
,	,	Z
13.	13.	Mdo
travnja	travanj	Ncmsg
2016.	2016.	Mdo

Predsjednik	predsjednik	Ncmsn
Savjeta	savjet	Ncmsg
Hrvatske	hrvatski	Agpfsgy
narodne	narodni	Agpfsgy
banke	banka	Ncfsg
guverner	guverner	Ncmsn
Hrvatske	hrvatski	Agpfsgy
narodne	narodni	Agpfsgy
banke	banka	Ncfsg
prof.	prof.	Y
dr.	dr.	Y
sc.	sc.	Y
Boris	Boris	Npmsn
Vujčić	Vujčić	Npmsn
,	,	Z
v.	v.	Y
r.	r.	Y

