da	da	Cs
se	sebe	Px--sa
trajanje	trajanje	Ncnsn
neprekidno	neprekidno	Rgp
prijavljenog	prijaviti	Agpnsgy
prebivališta	prebivalište	Ncnsg
i	i	Cc
boravišta	boravište	Ncnsg
obveznika	obveznik	Ncmpg
plaćanja	plaćanje	Ncnsg
komunalnog	komunalan	Agpmsgy
doprinosa	doprinos	Ncmsg
na	na	Sl
području	područje	Ncnsl
te	taj	Pd-fsg
jedinice	jedinica	Ncfsg
lokalne	lokalan	Agpfsgy
samouprave	samouprava	Ncfsg
utvrđuje	utvrđivati	Vmr3s
potvrdom	potvrda	Ncfsi
nadležne	nadležan	Agpfsgy
policijske	policijski	Agpfsgy
postaje	postaja	Ncfsg
,	,	Z
ograničava	ograničavati	Vmr3s
se	sebe	Px--sa
mogućnost	mogućnost	Ncfsn
poduzimanja	poduzimanje	Ncnsg
procesnih	procesni	Agpfpgy
radnji	radnja	Ncfpg
radi	radi	Sg
utvrđivanja	utvrđivanje	Ncnsg
pravno	pravno	Rgp
relevantne	relevantan	Agpfsgy
činjenice	činjenica	Ncfsg
i	i	Cc
to	to	Qo
trajanja	trajanje	Ncnsg
prebivališta	prebivalište	Ncnsg
odnosno	odnosno	Rgp
boravišta	boravište	Ncnsg
,	,	Z
koja	koji	Pi-fsn
je	biti	Var3s
bitna	bitan	Agpfsny
za	za	Sa
donošenje	donošenje	Ncnsa
zakonitog	zakonit	Agpmsgy
i	i	Cc
pravilnog	pravilan	Agpnsgy
rješenja	rješenje	Ncnsg
o	o	Sl
komunalnom	komunalan	Agpmsly
doprinosu	doprinos	Ncmsl
.	.	Z

Ovakvo	ovakav	Pd-nsn
ograničavanje	ograničavanje	Ncnsn
protivno	protivan	Agpnsny
je	biti	Var3s
temeljnim	temeljan	Agpfpiy
odredbama	odredba	Ncfpi
Zakona	zakon	Ncmsg
o	o	Sl
općem	opći	Agpmsly
upravnom	upravan	Agpmsly
postupku	postupak	Ncmsl
.	.	Z

Iz	iz	Sg
navedenog	naveden	Agpnsgy
slijedi	slijediti	Vmr3s
da	da	Cs
je	biti	Var3s
predstavničko	predstavnički	Agpnsny
tijelo	tijelo	Ncnsn
Općine	općina	Ncfsg
Bol	bol	Agpfsgy
dijelom	dio	Agpfsgy
odredbe	odredba	Ncfsg
članka	članak	Ncmsg
6.	6.	Mdo
alineje	alineja	Ncfsg
1.	1.	Mdo
Odluke	odluka	Ncfsg
o	o	Sl
komunalnom	komunalan	Agpmsly
doprinosu	doprinos	Ncmsl
prekoračilo	prekoračiti	Vmp-sn
zakonom	zakon	Ncmsi
propisane	propisati	Agpfsgy
ovlasti	ovlast	Ncfsg
,	,	Z
zbog	zbog	Sg
čega	što	Pi3n-g
je	biti	Var3s
Sud	sud	Ncmsn
temeljem	temelj	Ncmsi
odredbe	odredba	Ncfsg
članka	članak	Ncmsg
86.	86.	Mdo
stavka	stavak	Ncmsg
3.	3.	Mdo
Zakona	zakon	Ncmsg
o	o	Sl
upravnim	upravan	Agpmply
sporovima	spor	Ncmpl
odlučio	odlučiti	Vmp-sm
kao	kao	Cs
u	u	Sl
izreci	izreka	Ncfsl
.	.	Z

Sukladno	sukladno	Rgp
odredbi	odredba	Ncfsl
članka	članak	Ncmsg
86.	86.	Mdo
stavka	stavak	Ncmsg
4.	4.	Mdo
Zakona	zakon	Ncmsg
o	o	Sl
upravnim	upravan	Agpmply
sporovima	spor	Ncmpl
ukinuti	ukinuti	Vmn
dio	dio	Ncmsan
odredbe	odredba	Ncfsg
općeg	opći	Agpmsgy
akta	akt	Ncmsg
prestaje	prestajati	Vmr3s
važiti	važiti	Vmn
danom	dan	Ncmsi
objave	objava	Ncfsg
ove	ovaj	Pd-fsg
presude	presuda	Ncfsg
u	u	Sl
»	»	Z
Narodnim	narodni	Agpfply
novinama	novina	Ncfpl
«	«	Z
.	.	Z

Broj	broj	Ncmsn
:	:	Z
Usoz-26	Usoz-26	Mds
/	/	Z
16	16	Mdc
-	-	Z
3	3	Mdc

Zagreb	Zagreb	Npmsn
,	,	Z
29.	29.	Mdo
ožujka	ožujak	Ncmsg
2016.	2016.	Mdo

Predsjednica	predsjednica	Ncfsn
vijeća	vijeće	Ncnsg
Ana	Ana	Npfsn
Berlengi	Berlengi	Npfsn
Fellner	Fellner	Npfsn
,	,	Z
v.	v.	Y
r.	r.	Y

