doprinosa	doprinos	Ncmsg
ograničilo	ograničiti	Vmp-sn
mogućnost	mogućnost	Ncfsa
dokazivanja	dokazivanje	Ncnsg
prebivališta	prebivalište	Ncnsg
isključivo	isključivo	Rgp
uvjerenjem	uvjerenje	Ncnsi
nadležnog	nadležan	Agpnsgy
tijela	tijelo	Ncnsg
,	,	Z
prekoračilo	prekoračiti	Vmp-sn
zakonom	zakon	Ncmsi
propisane	propisati	Agpfsgy
ovlasti	ovlast	Ncfsg
,	,	Z
slijedom	slijed	Ncmsi
čega	što	Pi3n-g
je	biti	Var3s
Sud	sud	Ncmsn
temeljem	temelj	Ncmsi
odredbe	odredba	Ncfsg
članka	članak	Ncmsg
86.	86.	Mdo
stavak	stavak	Ncmsn
3.	3.	Mdo
Zakona	zakon	Ncmsg
o	o	Sl
upravnim	upravan	Agpmply
sporovima	spor	Ncmpl
donio	donijeti	Vmp-sm
odluku	odluka	Ncfsa
kao	kao	Cs
u	u	Sl
izreci	izreka	Ncfsl
.	.	Z

Sukladno	sukladno	Rgp
odredbi	odredba	Ncfsl
članka	članak	Ncmsg
86.	86.	Mdo
stavak	stavak	Ncmsn
4.	4.	Mdo
Zakona	zakon	Ncmsg
o	o	Sl
upravnim	upravan	Agpmply
sporovima	spor	Ncmpl
ukinuti	ukinuti	Vmn
dio	dio	Ncmsan
odredbe	odredba	Ncfsg
općeg	opći	Agpmsgy
akta	akt	Ncmsg
prestaje	prestajati	Vmr3s
važiti	važiti	Vmn
danom	dan	Ncmsi
objave	objava	Ncfsg
ove	ovaj	Pd-fsg
presude	presuda	Ncfsg
u	u	Sl
»	»	Z
Narodnim	narodni	Agpfply
novinama	novina	Ncfpl
«	«	Z
.	.	Z

Broj	broj	Ncmsn
:	:	Z
Usoz-40	Usoz-40	Mds
/	/	Z
16	16	Mdc
-	-	Z
3	3	Mdc

Zagreb	Zagreb	Npmsn
,	,	Z
29.	29.	Mdo
travnja	travanj	Ncmsg
2016.	2016.	Mdo

Predsjednica	predsjednica	Ncfsn
vijeća	vijeće	Ncnsg
Arma	Arma	Npfsn
Vagner	Vagner	Npmsn
Popović	Popović	Npmsn
,	,	Z
v.	v.	Y
r.	r.	Y

