navodno	navodno	Rgp
pogrešnoj	pogrešan	Agpfsly
ili	ili	Cc
nepotpuno	nepotpuno	Rgp
utvrđenom	utvrditi	Agpnsly
činjeničnom	činjeničan	Agpnsly
stanju	stanje	Ncnsl
.	.	Z

Ovo	ovaj	Pd-nsn
iz	iz	Sg
razloga	razlog	Ncmsg
što	što	Cs
tužitelj	tužitelj	Ncmsn
u	u	Sl
svojem	svoj	Px-nsl
očitovanju	očitovanje	Ncnsl
nije	biti	Var3s
ukazivao	ukazivati	Vmp-sm
da	da	Cs
su	biti	Var3p
cijene	cijena	Ncfpn
ponuđene	ponuditi	Appfpny
u	u	Sl
postupcima	postupak	Ncmpl
javne	javan	Agpfsgy
nabave	nabava	Ncfsg
bile	biti	Vap-pf
sukladne	sukladan	Agpfpny
regulatornoj	regulatoran	Agpfsly
obvezi	obveza	Ncfsl
nadzora	nadzor	Ncmsg
cijena	cijena	Ncfpg
.	.	Z

Samim	sam	Agpnsiy
time	taj	Pd-nsi
nije	biti	Var3s
doveo	dovesti	Vmp-sm
u	u	Sa
sumnju	sumnja	Ncfsa
činjenično	činjeničan	Agpnsay
stanje	stanje	Ncnsa
koje	koji	Pi-nsn
je	biti	Var3s
nesporno	nesporno	Rgp
utvrdio	utvrditi	Vmp-sm
nadležni	nadležan	Agpmsny
inspektor	inspektor	Ncmsn
.	.	Z

Pored	pored	Sg
navedenog	naveden	Agpmsgy
treba	trebati	Vmr3s
istaknuti	istaknuti	Vmn
da	da	Cs
suprotno	suprotno	Rgp
navodima	navod	Ncmpd
tužitelja	tužitelj	Ncmpg
,	,	Z
osporeno	osporiti	Agpnsny
rješenje	rješenje	Ncnsn
sadrži	sadržati	Vmr3s
sve	sav	Agpmpay
elemente	element	Ncmpa
propisane	propisati	Agpmpay
odredbom	odredba	Ncfsi
članka	članak	Ncmsg
98.	98.	Mdo
stavka	stavak	Ncmsg
5.	5.	Mdo
Zakona	zakon	Ncmsg
o	o	Sl
općem	opći	Agpmsly
upravnom	upravan	Agpmsly
postupku	postupak	Ncmsl
.	.	Z

Kako	kako	Cs
su	biti	Var3p
,	,	Z
dakle	dakle	Cc
,	,	Z
za	za	Sa
rješavanje	rješavanje	Ncnsa
predmetne	predmetni	Agpfsgy
upravne	upravan	Agpfsgy
stvari	stvar	Ncfsg
mjerodavne	mjerodavan	Agpfsgy
odredbe	odredba	Ncfsg
ZEK-a	ZEK	Npmsg
primjenom	primjena	Ncfsi
kojeg	koji	Pi-msay
je	biti	Var3s
tuženik	tuženik	Ncmsn
obavio	obaviti	Vmp-sm
nadzor	nadzor	Ncmsan
i	i	Cc
naredio	narediti	Vmp-sm
uklanjanje	uklanjanje	Ncnsa
opisanih	opisati	Agpfpgy
nepravilnosti	nepravilnost	Ncfpg
,	,	Z
to	taj	Pd-nsn
Sud	sud	Ncmsn
nalazi	nalaziti	Vmr3s
da	da	Cs
je	biti	Var3s
osporeno	osporiti	Agpnsny
rješenje	rješenje	Ncnsn
doneseno	donijeti	Appnsny
u	u	Sl
granicama	granica	Ncfpl
zakonom	zakon	Ncmsi
propisanih	propisati	Appfpgy
ovlasti	ovlast	Ncfpg
tuženika	tuženik	Ncmpg
,	,	Z
koje	koji	Pi-nsn
je	biti	Var3s
za	za	Sa
svoju	svoj	Px-fsa
odluku	odluka	Ncfsa
navelo	navesti	Vmp-sn
pravno	pravno	Rgp
relevantne	relevantan	Agpmpay
razloge	razlog	Ncmpa
,	,	Z
obrazložene	obrazložiti	Appfpny
u	u	Sl
smislu	smisao	Ncmsl
članka	članak	Ncmsg
98.	98.	Mdo
stavka	stavak	Ncmsg
5.	5.	Mdo
Zakona	zakon	Ncmsg
o	o	Sl
općem	opći	Agpmsly
upravnom	upravan	Agpmsly
postupku	postupak	Ncmsl
(	(	Z
»	»	Z
Narodne	narodni	Agpfpny
novine	novina	Ncfpn
«	«	Z
47/09.	47/09.	Mdo
)	)	Z
a	a	Cc
koje	koji	Pi-nsn
prihvaća	prihvaćati	Vmr3s
i	i	Qo
ovaj	ovaj	Pd-msn
Sud	sud	Ncmsn
u	u	Sl
cijelosti	cijelost	Ncfsl
,	,	Z
jer	jer	Cs
su	biti	Var3p
utemeljeni	utemeljiti	Appmpny
na	na	Sl
podacima	podatak	Ncmpl
spisa	spis	Ncmpg
predmeta	predmet	Ncmsg
i	i	Cc
pravilnoj	pravilan	Agpfsly
primjeni	primjena	Ncfsl
mjerodavnog	mjerodavan	Agpnsgy
materijalnog	materijalan	Agpnsgy
prava	pravo	Ncnsg
.	.	Z

Radi	radi	Sg
navedenog	naveden	Agpmsgy
,	,	Z
Sud	sud	Ncmsn
nije	biti	Var3s
našao	naći	Vmp-sm
osnova	osnova	Ncfsn
osporeno	osporiti	Appnsny
rješenje	rješenje	Ncnsn
ocijeniti	ocijeniti	Vmn
nezakonitim	nezakonit	Agpmsiy
.	.	Z

Trebalo	trebati	Vmp-sn
je	biti	Var3s
stoga	stoga	Rgp
,	,	Z
temeljem	temelj	Sg
odredbe	odredba	Ncfsg
članka	članak	Ncmsg
57.	57.	Mdo
stavka	stavak	Ncmsg
1.	1.	Mdo
Zakona	zakon	Ncmsg
o	o	Sl
upravnim	upravan	Agpmply
sporovima	spor	Ncmpl
,	,	Z
tužbeni	tužbeni	Agpmsayn
zahtjev	zahtjev	Ncmsan
odbiti	odbiti	Vmn
kao	kao	Cs
neosnovan	neosnovan	Agpmsnn
.	.	Z

Poslovni	poslovan	Agpmsny
broj	broj	Ncmsn
:	:	Z
UsII-50	UsII-50	Mds
/	/	Z
13	13	Mdc
-	-	Z
11	11	Mdc

Zagreb	Zagreb	Npmsn
,	,	Z
3.	3.	Mdo
svibnja	svibanj	Ncmsg
2016.	2016.	Mdo

Predsjednik	predsjednik	Ncmsn
vijeća	vijeće	Ncnsg
mr.	mr.	Y
sc.	sc.	Y
Ivica	Ivica	Npmsn
Kujundžić	Kujundžić	Npmsn
,	,	Z
v.	v.	Y
r.	r.	Y

