19	19	Mdc
20.02.2015	20.02.2015	Mdo
Odluka	odluka	Ncfsn
o	o	Sl
imenovanju	imenovanje	Ncnsl
dva	dva	Mlc
člana	član	Ncmsg
Sveučilišnog	sveučilišni	Agpmsgy
savjeta	savjet	Ncmsg
Sveučilišta	sveučilište	Ncnsg
u	u	Sl
Zagrebu	Zagreb	Npmsl

HRVATSKI	hrvatski	Agpmsny
SABOR	sabor	Ncmsn

405	405	Mdc

Na	na	Sl
temelju	temelj	Ncmsl
članka	članak	Ncmsg
81.	81.	Mdo

Ustava	ustava	Ncfsn
Republike	republika	Ncfsg
Hrvatske	Hrvatska	Npfsg
,	,	Z
Hrvatski	hrvatski	Agpmsny
sabor	sabor	Ncmsn
na	na	Sl
sjednici	sjednica	Ncfsl
13.	13.	Mdo
veljače	veljača	Ncfsg
2015.	2015.	Mdo
,	,	Z
donio	donijeti	Vmp-sm
je	biti	Var3s

ODLUKU	odluka	Ncfsa

O	o	Sl
IMENOVANJU	imenovanje	Ncnsl
DVA	dva	Mlc
ČLANA	član	Ncmsg
SVEUČILIŠNOG	sveučilišni	Agpmsgy
SAVJETA	savjet	Ncmsg
SVEUČILIŠTA	sveučilište	Ncnsg
U	u	Sl
ZAGREBU	Zagreb	Npmsl

Za	za	Sa
članove	član	Ncmpa
Sveučilišnog	sveučilišni	Agpmsgy
savjeta	savjet	Ncmsg
Sveučilišta	sveučilište	Ncnsg
u	u	Sl
Zagrebu	Zagreb	Npmsl
imenuju	imenovati	Vmr3p
se	sebe	Px--sa
:	:	Z

–	–	Agpmsny
akademik	akademik	Ncmsn
ŽELJKO	Željko	Npmsn
REINER	REINER	Npmsn

–	–	Z
prof.	prof.	Y
dr.	dr.	Y
sc.	sc.	Y
GVOZDEN	GVOZDEN	Npmsn
SREĆKO	SREĆKO	Npmsn
FLEGO	FLEGO	Npmsn
.	.	Z

Klasa	klasa	Ncfsn
:	:	Z
021	021	Mdc
-	-	Z
13/14	13/14	Mdc
-	-	Z
06/09	06/09	Mdc

Zagreb	Zagreb	Npmsn
,	,	Z
13.	13.	Mdo
veljače	veljača	Ncfsg
2015.	2015.	Mdo

HRVATSKI	hrvatski	Agpmsny
SABOR	sabor	Ncmsn

Predsjednik	predsjednik	Ncmsn
Hrvatskoga	hrvatski	Agpmsgy
sabora	sabor	Ncmsg
Josip	Josip	Npmsn
Leko	Leko	Npmsn
,	,	Z
v.	v.	Y
r.	r.	Y

