likvidna	likvidan	Agpnpay
devizna	devizni	Agpnpay
potraživanja	potraživanje	Ncnpa
uključuju	uključivati	Vmr3p
se	sebe	Px--sa
i	i	Cc
obratni	obratan	Agpmpny
repo	repa	Agpmpny
poslovi	posao	Ncmpn
,	,	Z
koji	koji	Pi-mpn
dospijevaju	dospijevati	Vmr3p
najkasnije	kasno	Rgs
za	za	Sa
3	3	Mdc
mjeseca	mjesec	Ncmsg
,	,	Z
ako	ako	Cs
već	već	Rgp
nisu	biti	Var3p
uključeni	uključiti	Appmpny
u	u	Sa
ostale	ostali	Agpfpay
gore	gora	Ncfpa
navedene	naveden	Agpmpay
račune	račun	Ncmpa
.	.	Z

OBRASCI	obrazac	Ncmpn

