75	75	Mdc
17.08.2016	17.08.2016	Mdo
Odluka	odluka	Ncfsn
o	o	Sl
objavljivanju	objavljivanje	Ncnsl
Jedinstvenog	jedinstven	Agpmsgy
okvirnog	okviran	Agpmsgy
kontnog	kontni	Agpmsgy
plana	plan	Ncmsg

ODBOR	odbor	Ncmsn
ZA	za	Sa
STANDARDE	standard	Ncmpa
FINANCIJSKOG	financijski	Agpnsgy
IZVJEŠTAVANJA	izvještavanje	Ncnsg

1762	1762	Mdc

Na	na	Sl
temelju	temelj	Ncmsl
članka	članak	Ncmsg
11.	11.	Mdo
stavka	stavak	Ncmsg
3.	3.	Mdo
Zakona	zakon	Ncmsg
o	o	Sl
računovodstvu	računovodstvo	Ncnsl
(	(	Z
»	»	Z
Narodne	narodni	Agpfpny
novine	novina	Ncfpn
«	«	Z
,	,	Z
br.	br.	Y
78/15	78/15	Mdc
i	i	Cc
134/15	134/15	Mdc
)	)	Z
Odbor	odbor	Ncmsn
za	za	Sa
standarde	standard	Ncmpa
financijskog	financijski	Agpnsgy
izvještavanja	izvještavanje	Ncnsg
na	na	Sl
sjednici	sjednica	Ncfsl
održanoj	održati	Appfsly
1.	1.	Mdo
kolovoza	kolovoz	Ncmsg
2016.	2016.	Mdo
godine	godina	Ncfsg
donio	donijeti	Vmp-sm
je	biti	Var3s

ODLUKU	odluka	Ncfsa

O	o	Sl
OBJAVLJIVANJU	objavljivanje	Ncnsl
JEDINSTVENOG	jedinstven	Agpmsgy
OKVIRNOG	okviran	Agpmsgy
KONTNOG	kontni	Agpmsgy
PLANA	plan	Ncmsg

Članak	članak	Ncmsn
1.	1.	Mdo

Objavljuje	objavljivati	Vmr3s
se	sebe	Px--sa
Jedinstveni	jedinstven	Agpmsny
okvirni	okviran	Agpmsny
kontni	kontni	Agpmsny
plan	plan	Ncmsn
koji	koji	Pi-msn
se	sebe	Px--sa
nalazi	nalaziti	Vmr3s
u	u	Sl
privitku	privitak	Ncmsl
ove	ovaj	Pd-fsg
Odluke	odluka	Ncfsg
i	i	Cc
čini	činiti	Vmr3s
njezin	njezin	Ps3msn
sastavni	sastavan	Agpmsny
dio	dio	Ncmsn
.	.	Z

Članak	članak	Ncmsn
2.	2.	Mdo

Poduzetnici	poduzetnica	Ncmpn
su	biti	Var3p
dužni	dužan	Agpmpny
prilikom	prilikom	Sg
evidentiranja	evidentiranje	Ncnsg
poslovnih	poslovan	Agpmpgy
događaja	događaj	Ncmpg
u	u	Sa
svoje	svoj	Px-fpa
poslovne	poslovan	Agpfpay
knjige	knjiga	Ncfpa
koristiti	koristiti	Vmn
propisani	propisati	Appmpny
Jedinstveni	jedinstven	Agpmsny
okvirni	okviran	Agpmsny
kontni	kontni	Agpmsny
plan	plan	Ncmsn
,	,	Z
osim	osim	Sg
poduzetnika	poduzetnik	Ncmpg
čije	čiji	Pi-nsn
poslovanje	poslovanje	Ncnsn
je	biti	Var3s
uređeno	urediti	Appnsny
posebnim	poseban	Agpmpiy
propisima	propis	Ncmpi
,	,	Z
a	a	Cc
kojima	koji	Pi-mpl
kontni	kontni	Agpmsny
plan	plan	Ncmsn
propisuju	propisivati	Vmr3p
nadzorna	nadzorni	Agpnpay
tijela	tijelo	Ncnpa
ovlaštena	ovlašten	Agpnpay
za	za	Sa
nadzor	nadzor	Ncmsan
poslovanja	poslovanje	Ncnsg
tih	taj	Pd-mpg
poduzetnika	poduzetnik	Ncmpg
.	.	Z

Članak	članak	Ncmsn
3.	3.	Mdo

Ova	ovaj	Pd-fsn
Odluka	odluka	Ncfsn
stupa	stupati	Vmr3s
na	na	Sa
snagu	snaga	Ncfsa
1.	1.	Mdo
siječnja	siječanj	Ncmsg
2017.	2017.	Mdo
godine	godina	Ncfsg
.	.	Z

Predsjednik	predsjednik	Ncmsn
Odbora	odbor	Ncmsg
za	za	Sa
standarde	standard	Ncmpa
financijskog	financijski	Agpnsgy
izvještavanja	izvještavanje	Ncnsg
Ivica	Ivica	Npmsn
Smiljan	Smiljan	Npmsn
,	,	Z
v.	v.	Y
r.	r.	Y

Jedinstveni	jedinstven	Agpmsny
okvirni	okviran	Agpmsny
kontni	kontni	Agpmsny
plan	plan	Ncmsn

