rasporedu	raspored	Ncmsl
22	22	Mdc
Povećanje	povećanje	Ncnsn
rezervi	rezerva	Ncfsl
u	u	Sl
postupku	postupak	Ncmsl
predstečajne	predstečajni	Agpfsgy
nagodbe	nagodba	Ncfsg
23	23	Mdc
Stanje	stanje	Ncnsn
31.	31.	Mdo
prosinca	prosinac	Ncmsg
tekućeg	tekući	Agpmsayn
raz	raz	Ncmsan
-	-	Z
doblja	doblj	Ncmpg
DODATAK	dodatak	Ncmsn
IZVJEŠTAJU	izvještaj	Ncmsl
O	o	Sl
PROMJENAMA	promjena	Ncfpl
KAPITALA	kapital	Ncmsg
(	(	Z
popunjava	popunjavati	Vmr3s
poduzetnik	poduzetnik	Ncmsn
obveznik	obveznik	Ncmsn
primjene	primjena	Ncfsg
MSFI-a	MSFI	Npmsg
)	)	Z
I	i	Cc
OSTALA	ostali	Agpfsny
SVEOBUHVATNA	sveobuhvatan	Agpfsny
DOBIT	dobit	Ncfsn
TEKUĆEG	tekući	Agpnsgy
RAZDOBLJA	razdoblje	Ncnsg
,	,	Z
UMANJENO	umanjiti	Appnsny
ZA	za	Sa
POREZE	porez	Ncmpa
II	ii	Pi-mpa
SVEOBUHVATNA	sveobuhvatan	Agpfsny
DOBIT	dobit	Ncfsn
ILI	ili	Cc
GUBITAK	gubitak	Ncmsan
TEKUĆEG	tekući	Agpnsgy
RAZDOBLJA	razdoblje	Ncnsg
III	III	Agpfsgy
TRANSAKCIJE	transakcija	Ncfsg
S	sa	Si
VLASNICIMA	vlasnik	Ncmpi
TEKUĆEG	tekući	Agpnsgy
RAZDOBLJA	razdoblje	Ncnsg
PRIZNATE	priznati	Vmr2p
DIREKTNO	direktno	Rgp
U	u	Sl
KAPITALU	kapital	Ncmsl

