korisniku	korisnik	Ncmsd
.	.	Z

Način	način	Ncmsn
i	i	Cc
oblik	oblik	Ncmsan
čuvanja	čuvanje	Ncnsg
dokumentacije	dokumentacija	Ncfsg

Svi	sav	Agpmpny
popratni	popratni	Agpmpny
dokumenti	dokument	Ncmpn
vezani	vezan	Agpmpny
uz	uz	Sa
troškove	trošak	Ncmpa
za	za	Sa
koje	koji	Pi-mpa
je	biti	Var3s
korisnik	korisnik	Ncmsn
ostvario	ostvariti	Vmp-sm
potporu	potpora	Ncfsa
iz	iz	Sg
Europskog	europski	Agpmsgy
fonda	fond	Ncmsg
za	za	Sa
pomorstvo	pomorstvo	Ncnsa
i	i	Cc
ribarstvo	ribarstvo	Ncnsa
se	sebe	Px--sa
čuvaju	čuvati	Vmr3p
u	u	Sl
izvornicima	izvornik	Ncmpl
,	,	Z
osim	osim	Sg
računovodstvenih	računovodstveni	Agpmpgy
podataka	podatak	Ncmpg
koji	koji	Pi-mpn
se	sebe	Px--sa
mogu	moći	Vmr3p
čuvati	čuvati	Vmn
u	u	Sl
elektroničkoj	elektronički	Agpfsly
verziji	verzija	Ncfsl
,	,	Z
pod	pod	Si
uvjetom	uvjet	Ncmsi
da	da	Cs
takvi	takav	Pd-mpn
računalni	računalni	Agpmpny
sustavi	sustav	Ncmpn
ispunjavaju	ispunjavati	Vmr3p
prihvaćene	prihvatiti	Agpmpay
sigurnosne	sigurnosni	Agpmpay
standarde	standard	Ncmpa
koji	koji	Pi-mpn
osiguravaju	osiguravati	Vmr3p
da	da	Cs
su	biti	Var3p
pohranjeni	pohraniti	Appmpny
dokumenti	dokument	Ncmpn
u	u	Sl
skladu	sklad	Ncmsl
s	sa	Si
nacionalnim	nacionalan	Agpmpiy
zakonski	zakonski	Rgp
propisanim	propisati	Agpmpiy
zahtjevima	zahtjev	Ncmpi
i	i	Cc
da	da	Cs
se	sebe	Px--sa
u	u	Sa
njih	oni	Pp3-pa
može	moći	Vmr3s
pouzdati	pouzdati	Vmn
u	u	Sa
svrhu	svrha	Ncfsa
revizije	revizija	Ncfsg
.	.	Z

Dokumentacija	dokumentacija	Ncfsn
najmanje	malo	Rgs
sadrži	sadržati	Vmr3s
,	,	Z
za	za	Sa
svaku	svaki	Pi-fsa
operaciju	operacija	Ncfsa
,	,	Z
prema	prema	Sl
potrebi	potreba	Ncfsl
,	,	Z
tehničke	tehnički	Agpfsgy
specifikacije	specifikacija	Ncfsg
i	i	Cc
plan	plan	Ncmsan
sufinanciranja	sufinanciranje	Ncnsg
,	,	Z
dokument	dokument	Ncmsn
o	o	Sl
odobravanju	odobravanje	Ncnsl
bespovratnih	bespovratan	Agpnpgy
sredstava	sredstvo	Ncnpg
,	,	Z
gdje	gdje	Cs
je	biti	Var3s
to	taj	Pd-nsn
potrebno	potreban	Agpnsny
dokumente	dokument	Ncmpa
vezane	vezan	Agpmpay
uz	uz	Sa
postupke	postupak	Ncmpa
javne	javan	Agpfsgy
nabave	nabava	Ncfsg
,	,	Z
izvješća	izvješće	Ncnsg
korisnika	korisnik	Ncmpg
i	i	Cc
izvješća	izvješće	Ncnsg
o	o	Sl
provedenim	provesti	Agpfply
provjerama	provjera	Ncfpl
i	i	Cc
revizijama	revizija	Ncfpl
izvršenim	izvršen	Agpfpiy
nad	nad	Si
operacijama	operacija	Ncfpi
.	.	Z

Navedeni	naveden	Agpmpny
dokumenti	dokument	Ncmpn
moraju	morati	Vmr3p
biti	biti	Van
evidentirani	evidentirati	Appmpny
i	i	Cc
pohranjeni	pohraniti	Appmpny
na	na	Sa
način	način	Ncmsan
da	da	Cs
budu	biti	Var3p
lako	lako	Rgp
dostupni	dostupan	Agpmpny
osobama	osoba	Ncfpd
ili	ili	Cc
tijelima	tijelo	Ncnpl
koja	koji	Pi-npn
imaju	imati	Vmr3p
pravo	pravo	Ncnsa
na	na	Sa
pristup	pristup	Ncmsan
tim	taj	Pd-mpl
dokumentima	dokument	Ncmpl
te	te	Cc
je	biti	Var3s
korisnik	korisnik	Ncmsn
dužan	dužan	Agpmsnn
obavijestiti	obavijestiti	Vmn
Upravljačko	upravljački	Agpnsay
tijelo	tijelo	Ncnsa
o	o	Sl
točnoj	točan	Agpfsly
lokaciji	lokacija	Ncfsl
čuvanja	čuvanje	Ncnsg
navedenih	naveden	Agpmpgy
dokumenata	dokument	Ncmpg
putem	put	Sg
e-maila	e-mail	Ncmsg
:	:	Z
eufondovi.ribarstvo@mps.hr	eufondovi.ribarstvo@mps.hr	X
.	.	Z

Rok	rok	Ncmsn
čuvanja	čuvanje	Ncnsg
dokumentacije	dokumentacija	Ncfsg

Rok	rok	Ncmsn
za	za	Sa
čuvanje	čuvanje	Ncnsa
i	i	Cc
osiguravanje	osiguravanje	Ncnsa
dostupnosti	dostupnost	Ncfsg
dokumentacije	dokumentacija	Ncfsg
vezane	vezan	Agpfsgy
uz	uz	Sa
troškove	trošak	Ncmpa
za	za	Sa
koje	koji	Pi-mpa
je	biti	Var3s
korisniku	korisnik	Ncmsd
isplaćena	isplatiti	Appfsny
potpora	potpora	Ncfsn
iz	iz	Sg
Europskog	europski	Agpmsgy
fonda	fond	Ncmsg
za	za	Sa
pomorstvo	pomorstvo	Ncnsa
najmanje	malo	Rgs
dvije	dva	Mlcf-n
godine	godina	Ncfsg
od	od	Sg
31.	31.	Mdo
prosinca	prosinac	Ncmsg
nakon	nakon	Sg
predaje	predaja	Ncfsg
računa	račun	Ncmpg
u	u	Sl
kojima	koji	Pi-fpl
su	biti	Var3p
uključeni	uključiti	Appmpny
završni	završan	Agpmpny
troškovi	trošak	Ncmpn
operacije	operacija	Ncfsg
.	.	Z

Također	također	Rgp
,	,	Z
korisnik	korisnik	Ncmsn
je	biti	Var3s
dužan	dužan	Agpmsnn
dokumentaciju	dokumentacija	Ncfsa
čuvati	čuvati	Vmn
i	i	Cc
osigurati	osigurati	Vmn
dostupnost	dostupnost	Ncfsa
iste	isti	Agpfsgy
tijekom	tijekom	Sg
cjelokupnog	cjelokupan	Agpnsgy
razdoblja	razdoblje	Ncnsg
provođenja	provođenje	Ncnsg
operacije	operacija	Ncfsg
.	.	Z

