100	100	Mdc
02.11.2016	02.11.2016	Mdo
Odluka	odluka	Ncfsn
o	o	Sl
izboru	izbor	Ncmsl
predsjednice	predsjednica	Ncfsg
,	,	Z
potpredsjednika	potpredsjednik	Ncmpg
i	i	Cc
članova	član	Ncmpg
Odbora	odbor	Ncmsg
za	za	Sa
regionalni	regionalan	Agpmsayn
razvoj	razvoj	Ncmsan
i	i	Cc
fondove	fond	Ncmpa
Europske	europski	Agpfsgy
unije	unija	Ncfsg
Hrvatskoga	hrvatski	Agpmsgy
sabora	sabor	Ncmsg

HRVATSKI	hrvatski	Agpmsny
SABOR	sabor	Ncmsn

2114	2114	Mdc

Na	na	Sl
temelju	temelj	Ncmsl
članka	članak	Ncmsg
81.	81.	Mdo

Ustava	ustava	Ncfsn
Republike	republika	Ncfsg
Hrvatske	Hrvatska	Npfsg
i	i	Cc
članka	članak	Ncmsg
46.	46.	Mdo
i	i	Cc
102.	102.	Mdo

Poslovnika	poslovnik	Ncmsg
Hrvatskoga	hrvatski	Agpmsgy
sabora	sabor	Ncmsg
,	,	Z
Hrvatski	hrvatski	Agpmsny
sabor	sabor	Ncmsn
na	na	Sl
sjednici	sjednica	Ncfsl
28.	28.	Mdo
listopada	listopad	Ncmsg
2016.	2016.	Mdo
donio	donijeti	Vmp-sm
je	biti	Var3s

ODLUKU	odluka	Ncfsa

O	o	Sl
IZBORU	izbor	Ncmsl
PREDSJEDNICE	predsjednica	Ncfsg
,	,	Z
POTPREDSJEDNIKA	potpredsjednik	Ncmpg
I	i	Cc
ČLANOVA	član	Ncmpg
ODBORA	odbor	Ncmsg
ZA	za	Sa
REGIONALNI	regionalan	Agpmsayn
RAZVOJ	razvoj	Ncmsan
I	i	Cc
FONDOVE	fond	Ncmpa
EUROPSKE	europski	Agpfsgy
UNIJE	unija	Ncfsg
HRVATSKOGA	hrvatski	Agpmsgy
SABORA	sabor	Ncmsg

U	u	Sa
Odbor	odbor	Ncmsan
za	za	Sa
regionalni	regionalan	Agpmsayn
razvoj	razvoj	Ncmsan
i	i	Cc
fondove	fond	Ncmpa
Europske	europski	Agpfsgy
unije	unija	Ncfsg
Hrvatskoga	hrvatski	Agpmsgy
sabora	sabor	Ncmsg
biraju	birati	Vmr3p
se	sebe	Px--sa
:	:	Z

za	za	Sa
predsjednicu	predsjednica	Ncfsa

BRANKA	Branka	Npfsn
JURIČEV-MARTINČEV	JURIČEV-MARTINČEV	Npfsn

za	za	Sa
potpredsjednika	potpredsjednik	Ncmsay

DAMIR	Damir	Npmsn
MATELJAN	MATELJAN	Npmsn

za	za	Sa
članove	član	Ncmpa
:	:	Z

MARIJANA	MARIJANA	Npfsn
BALIĆ	Balić	Npfsn

GROZDANA	GROZDANA	Npfsn
PERIĆ	Perić	Npmsn

MILE	mio	Agpfpny
HORVAT	horvaa	Ncfpn

DARINKO	DARINKO	Npmsn
DUMBOVIĆ	DUMBOVIĆ	Npmsn

IVANA	Ivana	Npfsn
NINČEVIĆ-LESANDRIĆ	NINČEVIĆ-LESANDRIĆ	Npfsn

MARO	MARO	Npmsn
KRISTIĆ	KRISTIĆ	Npmsn

MILORAD	MILORAD	Npmsn
BATINIĆ	Batinić	Npmsn

SINIŠA	SINIŠA	Npfsn
VARGA	VARGA	Npfsn

STJEPAN	Stjepan	Npmsn
KOVAČ	KOVAČ	Npmsn

dr.	dr.	Y
sc.	sc.	Y
BRANKO	Branko	Npmsn
GRČIĆ	Grčić	Npmsn
.	.	Z

Klasa	klasa	Ncfsn
:	:	Z
021	021	Mdc
-	-	Z
13/16	13/16	Mdc
-	-	Z
03/90	03/90	Mdc

Zagreb	Zagreb	Npmsn
,	,	Z
28.	28.	Mdo
listopada	listopad	Ncmsg
2016.	2016.	Mdo

HRVATSKI	hrvatski	Agpmsny
SABOR	sabor	Ncmsn

Predsjednik	predsjednik	Ncmsn
Hrvatskoga	hrvatski	Agpmsgy
sabora	sabor	Ncmsg
Božo	Božo	Npmsn
Petrov	Petrov	Npmsn
,	,	Z
v.	v.	Y
r.	r.	Y

