grad	grad	Ncmsn
/	/	Z
regiju	regija	Ncfsa
)	)	Z
(	(	Z
adresa	adresa	Ncfsn
)	)	Z
:	:	Z
Adresa	adresa	Ncfsn
elektroničke	elektronički	Agpfsgy
pošte	pošta	Ncfsg
(	(	Z
ako	ako	Cs
postoji	postojati	Vmr3s
)	)	Z
:	:	Z
Jezici	jezik	Ncmpn
koji	koji	Pi-mpn
se	sebe	Px--sa
mogu	moći	Vmr3p
koristiti	koristiti	Vmn
za	za	Sa
komunikaciju	komunikacija	Ncfsa
:	:	Z
Potpis	potpis	Ncmsn
tijela	tijelo	Ncnsg
koje	koji	Pi-nsn
izdaje	izdavati	Vmr3s
obrazac	obrazac	Ncmsan
i	i	Cc
/	/	Z
ili	ili	Cc
njegovog	njegov	Ps3msg
predstavnika	predstavnik	Ncmpg
,	,	Z
kojim	koji	Pi-msi
se	sebe	Px--sa
potvrđuje	potvrđivati	Vmr3s
da	da	Cs
je	biti	Var3s
sadržaj	sadržaj	Ncmsn
obrasca	obrazac	Ncmsg
točan	točan	Agpmsnn
:	:	Z
Ime	ime	Ncnsn
:	:	Z
Funkcija	funkcija	Ncfsn
(	(	Z
titula	titula	Ncfsn
/	/	Z
službeni	služben	Agpmsny
položaj	položaj	Ncmsn
)	)	Z
:	:	Z
Datum	datum	Ncmsn
:	:	Z
Službeni	služben	Agpmsny
pečat	pečat	Ncmsn
(	(	Z
ako	ako	Cs
je	biti	Var3s
potrebno	potreban	Agpnsny
)	)	Z
:	:	Z

