mehanizme	mehanizam	Ncmpa
na	na	Sl
svim	sav	Agpfply
razinama	razina	Ncfpl
područja	područje	Ncnsg
prometa	promet	Ncmsg
i	i	Cc
infrastrukture	infrastruktura	Ncfsg
.	.	Z

CILJ	cilj	Ncmsn
:	:	Z
Jačanje	jačanje	Ncnsn
integriteta	integritet	Ncmsg
i	i	Cc
transparentnosti	transparentnost	Ncfsg
na	na	Sl
svim	sav	Agpfply
razinama	razina	Ncfpl
u	u	Sl
sustavu	sustav	Ncmsl
zaštite	zaštita	Ncfsg
okoliša	okoliš	Ncmsg
,	,	Z
prometa	promet	Ncmsg
i	i	Cc
infrastrukture	infrastruktura	Ncfsg

MJERE	mjera	Ncfpn
:	:	Z

1.	1.	Mdo
Jačanje	jačanje	Ncnsn
povjerenja	povjerenje	Ncnsg
korisnika	korisnik	Ncmpg
usluga	usluga	Ncfpg
u	u	Sl
sektoru	sektor	Ncmsl
graditeljstva	graditeljstvo	Ncnsg
i	i	Cc
prostornog	prostoran	Agpnsgy
uređenja	uređenje	Ncnsg
te	te	Cc
podizanje	podizanje	Ncnsa
svijesti	svijest	Ncfsg
o	o	Sl
štetnosti	štetnost	Ncfsl
korupcije	korupcija	Ncfsg

2.	2.	Mdo
Jačanje	jačanje	Ncnsn
kontrolnih	kontrolan	Agpmpgy
mehanizama	mehanizam	Ncmpg
na	na	Sl
svim	sav	Agpfply
razinama	razina	Ncfpl
unutar	unutar	Sg
sustava	sustav	Ncmsg
zaštite	zaštita	Ncfsg
okoliša	okoliš	Ncmsg
,	,	Z
prometa	promet	Ncmsg
i	i	Cc
infrastrukture	infrastruktura	Ncfsg

3.	3.	Mdo
Transparentnost	transparentnost	Ncfsn
rada	rad	Ncmsg
nadležnih	nadležan	Agpfpgy
inspekcija	inspekcija	Ncfpg

4.	4.	Mdo
Transparentno	transparentan	Agpnsny
izdavanje	izdavanje	Ncnsn
dozvola	dozvola	Ncfpg
i	i	Cc
licenci	licenca	Ncfpg

5.	5.	Mdo
Uspostavljanje	uspostavljanje	Ncnsn
neovisnog	neovisan	Agpmsgy
nadzornog	nadzorni	Agpmsgy
mehanizma	mehanizam	Ncmsg
za	za	Sa
vrijeme	vrijeme	Ncnsa
trajanja	trajanje	Ncnsg
projekta	projekt	Ncmsg
gradnje	gradnja	Ncfsg
infrastrukturnog	infrastrukturni	Agpmsgy
objekta	objekt	Ncmsg

6.	6.	Mdo
Provođenje	provođenje	Ncnsn
internog	interni	Agpmsgy
nadzora	nadzor	Ncmsg
i	i	Cc
interne	interni	Agpfsgy
revizije	revizija	Ncfsg
među	među	Si
svim	sav	Agpmpiy
dionicima	dionik	Ncmpi
provođenja	provođenje	Ncnsg
projekta	projekt	Ncmsg
u	u	Sl
području	područje	Ncnsl
prometa	promet	Ncmsg
i	i	Cc
infrastrukture	infrastruktura	Ncfsg
.	.	Z

Klasa	klasa	Ncfsn
:	:	Z
022	022	Mdc
-	-	Z
03/15	03/15	Mdc
-	-	Z
01/07	01/07	Mdc

Zagreb	Zagreb	Npmsn
,	,	Z
27.	27.	Mdo
veljače	veljača	Ncfsg
2015.	2015.	Mdo

HRVATSKI	hrvatski	Agpmsny
SABOR	sabor	Ncmsn

Predsjednik	predsjednik	Ncmsn
Hrvatskoga	hrvatski	Agpmsgy
sabora	sabor	Ncmsg
Josip	Josip	Npmsn
Leko	Leko	Npmsn
,	,	Z
v.	v.	Y
r.	r.	Y

