Slijedom	slijed	Ncmsi
toga	taj	Pd-nsg
,	,	Z
bit	biti	Van
će	htjeti	Var3s
potrebno	potreban	Agpnsny
uložiti	uložiti	Vmn
napore	napor	Ncmpa
u	u	Sa
svrhu	svrha	Ncfsa
osposobljavanja	osposobljavanje	Ncnsg
i	i	Cc
educiranja	educiranje	Ncnsg
službenika	službenik	Ncmpg
u	u	Sl
tijelima	tijelo	Ncnpl
državne	državni	Agpfsgy
uprave	uprava	Ncfsg
za	za	Sa
provedbu	provedba	Ncfsa
savjetovanja	savjetovanje	Ncnsg
i	i	Cc
korištenje	korištenje	Ncnsa
ovim	ovaj	Pd-msi
sustavom	sustav	Ncmsi
,	,	Z
kao	kao	Cs
i	i	Qo
u	u	Sa
kontinuirani	kontinuiran	Agpmsayn
rad	rad	Ncmsan
s	sa	Si
ciljem	cilj	Ncmsi
osiguravanja	osiguravanje	Ncnsg
funkcionalnosti	funkcionalnost	Ncfsg
tog	taj	Pd-msg
sustava	sustav	Ncmsg
.	.	Z

Također	također	Rgp
,	,	Z
u	u	Sa
svrhu	svrha	Ncfsa
informiranja	informiranje	Ncnsg
građana	građanin	Ncmpg
o	o	Sl
novom	nov	Agpmsly
alatu	alat	Ncmsl
za	za	Sa
njihovo	njihov	Ps3nsa
uključivanje	uključivanje	Ncnsa
u	u	Sa
procese	proces	Ncmpa
donošenja	donošenje	Ncnsg
odluka	odluka	Ncfsn
bit	biti	Van
će	htjeti	Var3s
potrebno	potreban	Agpnsny
provesti	provesti	Vmn
aktivnosti	aktivnost	Ncfpa
promocije	promocija	Ncfsg
sustava	sustav	Ncmsg
te	te	Cc
motiviranja	motiviranje	Ncnsg
građana	građanin	Ncmpg
na	na	Sa
uključivanje	uključivanje	Ncnsa
i	i	Cc
proaktivan	proaktivan	Agpmsann
pristup	pristup	Ncmsan
.	.	Z

Istraživačko	istraživački	Agpnsny
novinarstvo	novinarstvo	Ncnsn
kroz	kroz	Sa
svoju	svoj	Px-fsa
analitičnost	analitičnost	Ncfsa
,	,	Z
objektivnost	objektivnost	Ncfsa
i	i	Cc
nepristranost	nepristranost	Ncfsa
u	u	Sl
funkciji	funkcija	Ncfsl
ostvarenja	ostvarenje	Ncnsg
javnog	javan	Agpmsgy
interesa	interes	Ncmsg
predstavlja	predstavljati	Vmr3s
vrijedan	vrijedan	Agpmsann
medijski	medijski	Agpmsayn
doprinos	doprinos	Ncmsan
suzbijanju	suzbijanje	Ncnsd
korupcije	korupcija	Ncfsg
.	.	Z

Jedan	jedan	Mlcmsn
od	od	Sg
glavnih	glavni	Agpmpgy
ciljeva	cilj	Ncmpg
borbe	borba	Ncfsg
protiv	protiv	Sg
korupcije	korupcija	Ncfsg
jest	biti	Var3s
osiguranje	osiguranje	Ncnsn
respektabilnog	respektabilan	Agpmsgy
medijskog	medijski	Agpmsgy
integriteta	integritet	Ncmsg
.	.	Z

Ustavom	ustav	Ncmsi
Republike	republika	Ncfsg
Hrvatske	hrvatski	Agpfsgy
zaštićena	zaštititi	Appfsny
medijska	medijski	Agpfsny
sloboda	sloboda	Ncfsn
i	i	Cc
antikoruptivno	antikoruptivno	Rgp
neophodan	neophodan	Agpmsnn
medijski	medijski	Agpmsny
integritet	integritet	Ncmsn
neraskidivo	neraskidivo	Rgp
su	biti	Var3p
vezani	vezati	Appmpny
uz	uz	Sa
profesionalnu	profesionalan	Agpfsay
odgovornost	odgovornost	Ncfsa
svih	sav	Agpmpgy
medijskih	medijski	Agpmpgy
djelatnika	djelatnik	Ncmpg
.	.	Z

Za	za	Sa
ostvarenje	ostvarenje	Ncnsa
društvene	društven	Agpfsgy
svrhe	svrha	Ncfsg
medija	medij	Ncmpg
,	,	Z
potrebno	potreban	Agpnsny
je	biti	Var3s
djelovanje	djelovanje	Ncnsn
u	u	Sl
okvirima	okvir	Ncmpl
standarda	standard	Ncmpg
profesionalne	profesionalan	Agpfsgy
etike	etika	Ncfsg
novinarske	novinarski	Agpfsgy
struke	struka	Ncfsg
.	.	Z

Zahtjevi	zahtjev	Ncmpn
načela	načelo	Ncnpg
istinitosti	istinitost	Ncfsg
,	,	Z
objektivnosti	objektivnost	Ncfsg
,	,	Z
slobode	sloboda	Ncfsg
i	i	Cc
odgovornosti	odgovornost	Ncfsg
nalažu	nalagati	Vmr3p
restriktivniji	restriktivan	Agcmsayn
pristup	pristup	Ncmsan
kršenju	kršenje	Ncnsd
etičkih	etički	Agpmpgy
standarda	standard	Ncmpg
u	u	Sl
pokušaju	pokušaj	Ncmsl
osiguravanja	osiguravanje	Ncnsg
što	što	Pi3n-n
kvalitetnijeg	kvalitetan	Agpnsgy
izvršavanja	izvršavanje	Ncnsg
određenih	određen	Agpmpgy
društvenih	društven	Agpmpgy
zadataka	zadatak	Ncmpg
medijske	medijski	Agpfsgy
djelatnosti	djelatnost	Ncfsg
.	.	Z

Međutim	međutim	Rgp
,	,	Z
potrebno	potreban	Agpnsny
je	biti	Var3s
i	i	Cc
razlikovati	razlikovati	Vmn
slobodu	sloboda	Ncfsa
medija	medij	Ncmpg
,	,	Z
koju	koji	Pi-fsa
definiraju	definirati	Vmr3p
mediji	medij	Ncmpn
kao	kao	Cs
poduzeća	poduzeće	Ncnpn
koja	koji	Pi-npn
djeluju	djelovati	Vmr3p
na	na	Sl
tržištu	tržište	Ncnsl
,	,	Z
od	od	Sg
slobode	sloboda	Ncfsg
novinarstva	novinarstvo	Ncnsg
,	,	Z
koju	koji	Pi-fsa
označavaju	označavati	Vmr3p
novinari	novinar	Ncmpn
koji	koji	Pi-mpn
rade	raditi	Vmr3p
u	u	Sl
lošim	loš	Agpmply
ekonomskim	ekonomski	Agpmply
uvjetima	uvjet	Ncmpl
bez	bez	Sg
realne	realan	Agpfsgy
zaštite	zaštita	Ncfsg
od	od	Sg
zloupotreba	zloupotreba	Ncfpg
poslodavaca	poslodavac	Ncmpg
u	u	Sl
ekonomskom	ekonomski	Agpmsly
smislu	smisao	Ncmsl
(	(	Z
lažnim	lažan	Agpmpiy
RPO	r	Agpmpiy
ugovorima	ugovor	Ncmpi
i	i	Cc
nedostatkom	nedostatak	Ncmsi
kolektivnog	kolektivan	Agpmsgy
ugovora	ugovor	Ncmsg
)	)	Z
i	i	Cc
stručnom	stručan	Agpmsly
smislu	smisao	Ncmsl
(	(	Z
nema	nemati	Vmr3s
kontrole	kontrola	Ncfsg
poštivanja	poštivanje	Ncnsg
redakcijskih	redakcijski	Agpmpgy
statuta	statut	Ncmpg
iako	iako	Cs
su	biti	Var3p
oni	onaj	Pd-mpn
uvjet	uvjet	Ncmsan
za	za	Sa
smanjenje	smanjenje	Ncnsa
PDV-a	PDV	Npmsg
i	i	Cc
u	u	Sl
teoriji	teorija	Ncfsl
reguliraju	regulirati	Vmr3p
utjecaj	utjecaj	Ncmsan
novinara	novinar	Ncmpg
u	u	Sl
redakciji	redakcija	Ncfsl
na	na	Sa
izbor	izbor	Ncmsan
glavnog	glavni	Agpmsgy
urednika	urednik	Ncmsg
)	)	Z
.	.	Z

Svojom	svoj	Px-fsi
djelatnošću	djelatnost	Ncfsi
mediji	medij	Ncmpn
ograničavaju	ograničavati	Vmr3p
zlouporabu	zlouporaba	Ncfsa
moći	moć	Ncfsg
otkrivanjem	otkrivanje	Ncnsi
sumnjivih	sumnjiv	Agpmpgy
poslova	posao	Ncmpg
u	u	Sl
društvenim	društven	Agpfply
djelatnostima	djelatnost	Ncfpl
(	(	Z
politici	politika	Ncfsl
,	,	Z
gospodarstvu	gospodarstvo	Ncnsl
,	,	Z
upravi	uprava	Ncfsl
,	,	Z
pravosuđu	pravosuđe	Ncnsl
)	)	Z
,	,	Z
a	a	Cc
izuzetno	izuzetno	Rgp
su	biti	Var3p
značajni	značajan	Agpmpny
i	i	Cc
u	u	Sl
otkrivanju	otkrivanje	Ncnsl
možebitnih	možebitan	Agpfpgy
korupcijskih	korupcijski	Agpfpgy
afera	afera	Ncfpg
.	.	Z

Međutim	međutim	Rgp
,	,	Z
ostvarenje	ostvarenje	Ncnsn
koruptivnih	koruptivan	Agpmpgy
rizika	rizik	Ncmpg
u	u	Sl
medijima	medij	Ncmpl
onemogućuje	onemogućivati	Vmr3s
objektivno	objektivan	Agpnsay
informiranje	informiranje	Ncnsa
i	i	Cc
javni	javan	Agpmsayn
nadzor	nadzor	Ncmsan
nad	nad	Si
društvenim	društven	Agpfpiy
djelatnostima	djelatnost	Ncfpi
.	.	Z

Borba	borba	Ncfsn
protiv	protiv	Sg
korupcije	korupcija	Ncfsg
u	u	Sl
medijima	medij	Ncmpl
radi	radi	Sg
očuvanja	očuvanje	Ncnsg
javnog	javan	Agpmsgy
interesa	interes	Ncmsg
kao	kao	Cs
osnovne	osnovan	Agpfsgy
svrhe	svrha	Ncfsg
medija	medij	Ncmpg
mora	morati	Vmr3s
uključivati	uključivati	Vmn
razotkrivanje	razotkrivanje	Ncnsa
netransparentnih	netransparentan	Agpfpgy
vlasničkih	vlasnički	Agpfpgy
struktura	struktura	Ncfpg
i	i	Cc
načina	način	Ncmpg
financiranja	financiranje	Ncnsg
,	,	Z
osiguranje	osiguranje	Ncnsa
poštivanja	poštivanje	Ncnsg
profesionalnih	profesionalan	Agpmpgy
standarda	standard	Ncmpg
novinarske	novinarski	Agpfsgy
prakse	praksa	Ncfsg
te	te	Cc
jačanje	jačanje	Ncnsa
mehanizama	mehanizam	Ncmpg
zaštite	zaštita	Ncfsg
prava	pravo	Ncnsg
građana	građanin	Ncmpg
na	na	Sa
kvalitetnu	kvalitetan	Agpfsay
i	i	Cc
vjerodostojnu	vjerodostojan	Agpfsay
informaciju	informacija	Ncfsa
.	.	Z

Velik	velik	Agpmsnn
problem	problem	Ncmsn
medija	medij	Ncmpg
u	u	Sl
Republici	republika	Ncfsl
Hrvatskoj	Hrvatska	Npfsl
je	biti	Var3s
netransparentnost	netransparentnost	Ncfsa
vlasničke	vlasnički	Agpfsgy
strukture	struktura	Ncfsg
i	i	Cc
nedosljedna	nedosljedan	Agpfsny
provedba	provedba	Ncfsn
pojedinih	pojedini	Agpfpgy
odredbi	odredba	Ncfpg
Zakona	zakon	Ncmpg
o	o	Sl
medijima	medij	Ncmpl
i	i	Cc
Zakona	zakon	Ncmsg
o	o	Sl
elektroničkim	elektronički	Agpmply
medijima	medij	Ncmpl
kao	kao	Cs
što	što	Cs
su	biti	Var3p
one	onaj	Pd-fpn
vezane	vezan	Agpmpay
uz	uz	Sa
jednaku	jednak	Agpfsay
dostupnost	dostupnost	Ncfsa
javnih	javan	Agpfpgy
informacija	informacija	Ncfpg
i	i	Cc
godišnje	godišnje	Rgp
izvještaje	izvještaj	Ncmpa
Hrvatskoj	Hrvatska	Npfsl
gospodarskoj	gospodarski	Agpfsly
komori	komora	Ncfsl
o	o	Sl
vlasničkoj	vlasnički	Agpfsly
strukturi	struktura	Ncfsl
.	.	Z

Netransparentnost	netransparentnost	Ncfsn
privatnih	privatan	Agpmpgy
vlasničkih	vlasnički	Agpmpgy
odnosa	odnos	Ncmpg
nad	nad	Si
medijima	medij	Ncmpi
može	moći	Vmr3s
omogućiti	omogućiti	Vmn
promoviranje	promoviranje	Ncnsa
partikularnih	partikularan	Agpmpgy
interesa	interes	Ncmpg
određenih	određen	Agpfpgy
skupina	skupina	Ncfpg
dovodeći	dovoditi	Rr
tako	tako	Cs
u	u	Sa
pitanje	pitanje	Ncnsa
osnovnu	osnovan	Agpfsay
svrhu	svrha	Ncfsa
medijskog	medijski	Agpnsgy
djelovanja	djelovanje	Ncnsg
–	–	Z
očuvanje	očuvanje	Ncnsa
javnih	javan	Agpmpgy
interesa	interes	Ncmpg
i	i	Cc
interes	interes	Ncmsn
objektivnog	objektivan	Agpmsgy
i	i	Cc
potpunog	potpun	Agpnsgy
izvještavanja	izvještavanje	Ncnsg
javnosti	javnost	Ncfsg
.	.	Z

Unatoč	unatoč	Sd
relativno	relativno	Rgp
dobro	dobro	Rgp
definiranim	definirati	Agpfpiy
zakonskim	zakonski	Agpfpiy
regulacijama	regulacija	Ncfpi
spomenutog	spomenuti	Agpnsgy
područja	područje	Ncnsg
i	i	Cc
primijećenim	primijetiti	Agpmpiy
pozitivnim	pozitivan	Agpmpiy
pomacima	pomak	Ncmpi
osiguravanju	osiguravanje	Ncnsd
dostupnosti	dostupnost	Ncfsg
informacija	informacija	Ncfpg
građanima	građanin	Ncmpd
o	o	Sl
vlasništvu	vlasništvo	Ncnsl
u	u	Sl
medijima	medij	Ncmpl
,	,	Z
postoji	postojati	Vmr3s
potreba	potreba	Ncfsn
za	za	Si
daljnjim	daljnji	Agpmpiy
naporima	napor	Ncmpi
u	u	Sl
nadzoru	nadzor	Ncmsl
provedbe	provedba	Ncfsg
postojećih	postojeći	Agpmpgy
propisa	propis	Ncmpg
kako	kako	Cs
bi	biti	Vaa3s
se	sebe	Px--sa
omogućila	omogućiti	Vmp-sf
potpuna	potpun	Agpfsny
transparentnost	transparentnost	Ncfsn
medijskog	medijski	Agpnsgy
vlasništva	vlasništvo	Ncnsg
.	.	Z

Posebice	posebice	Rgp
je	biti	Var3s
osjetljiva	osjetljiv	Agpfsny
situacija	situacija	Ncfsn
s	sa	Si
lokalnim	lokalan	Agpmpiy
medijima	medij	Ncmpi
koji	koji	Pi-mpn
se	sebe	Px--sa
financiraju	financirati	Vmr3p
iz	iz	Sg
lokalnih	lokalan	Agpmpgy
javnih	javan	Agpmpgy
izvora	izvor	Ncmpg
te	te	Cc
gdje	gdje	Cs
ne	ne	Qz
postoji	postojati	Vmr3s
transparentnost	transparentnost	Ncfsn
utjecaja	utjecaj	Ncmsg
već	već	Rgp
permanentni	permanentan	Agpmsny
sukob	sukob	Ncmsn
interesa	interes	Ncmsg
ili	ili	Cc
barem	barem	Qo
situacija	situacija	Ncfsn
koja	koji	Pi-fsn
ne	ne	Qz
doprinosi	doprinositi	Vmr3s
izgradnji	izgradnja	Ncfsd
povjerenja	povjerenje	Ncnsg
građana	građanin	Ncmpg
u	u	Sa
lokalnu	lokalan	Agpfsay
političku	politički	Agpfsay
elitu	elita	Ncfsa
,	,	Z
pa	pa	Cc
ni	ni	Qo
u	u	Sa
lokalne	lokalan	Agpmpay
medije	medij	Ncmpa
.	.	Z

Treba	trebati	Vmr3s
težiti	težiti	Vmn
dodjeli	dodjela	Ncfsd
sredstava	sredstvo	Ncnpg
putem	put	Sg
natječaja	natječaj	Ncmsg
i	i	Cc
jasnih	jasan	Agpmpgy
kriterija	kriterij	Ncmpg
,	,	Z
koji	koji	Pi-mpn
umanjuju	umanjivati	Vmr3p
mogućnost	mogućnost	Ncfsa
pogodovanja	pogodovanje	Ncnsg
i	i	Cc
klijentelističke	klijentelistički	Agpfsgy
ovisnosti	ovisnost	Ncfsg
.	.	Z

CILJ	cilj	Ncmsn
:	:	Z
Jačanje	jačanje	Ncnsn
uloge	uloga	Ncfsg
organizacija	organizacija	Ncfsn
civilnog	civilan	Agpnsgy
društva	društvo	Ncnsg
,	,	Z
građana	građanin	Ncmpg
i	i	Cc
medija	medij	Ncmpg
u	u	Sl
suzbijanju	suzbijanje	Ncnsl
korupcije	korupcija	Ncfsg

MJERE	mjera	Ncfpn
:	:	Z

1.	1.	Mdo
Povećanje	povećanje	Ncnsn
transparentnosti	transparentnost	Ncfsg
suradnje	suradnja	Ncfsg
tijela	tijelo	Ncnsg
javne	javan	Agpfsgy
vlasti	vlast	Ncfsg
s	sa	Si
civilnim	civilan	Agpnsiy
društvom	društvo	Ncnsi

2.	2.	Mdo
Jačanje	jačanje	Ncnsn

