unaprijed	unaprijed	Rgp
definiranih	definirati	Agpfpgy
mjera	mjera	Ncfpg
i	i	Cc
postizanjem	postizanje	Ncnsi
postavljenih	postavljen	Agpmpgy
ciljeva	cilj	Ncmpg
,	,	Z
u	u	Sl
siječnju	siječanj	Ncmsl
2014.	2014.	Mdo
donesena	donijeti	Appfsny
je	biti	Var3s
Nacionalna	nacionalan	Agpfsny
strategija	strategija	Ncfsn
suzbijanja	suzbijanje	Ncnsg
prijevara	prijevara	Ncfpg
za	za	Sa
zaštitu	zaštita	Ncfsa
financijskih	financijski	Agpmpgy
interesa	interes	Ncmpg
Europske	europski	Agpfsgy
unije	unija	Ncfsg
za	za	Sa
razdoblje	razdoblje	Ncnsa
2014.	2014.	Mdo
–	–	Z
2016.	2016.	Mdo
i	i	Cc
Akcijski	akcijski	Agpmsayn
plan	plan	Ncmsan
.	.	Z

Jačanjem	jačanje	Ncnsi
AFCOS	AFCO	Npmsg
sustava	sustav	Ncmsg
i	i	Cc
djelotvornom	djelotvoran	Agpfsiy
zaštitom	zaštita	Ncfsi
financijskih	financijski	Agpmpgy
interesa	interes	Ncmpg
Europske	europski	Agpfsgy
unije	unija	Ncfsg
u	u	Sl
Republici	republika	Ncfsl
Hrvatskoj	Hrvatska	Npfsl
doprinosi	doprinositi	Vmr3s
se	sebe	Px--sa
sužavanju	sužavanje	Ncnsd
prostora	prostor	Ncmsg
za	za	Sa
pojavu	pojava	Ncfsa
korupcije	korupcija	Ncfsg
,	,	Z
a	a	Cc
samim	sam	Agpnsiy
time	taj	Pd-nsi
i	i	Qo
učinkovitom	učinkovit	Agpnsdy
upravljanju	upravljanje	Ncnsd
javnim	javan	Agpfpiy
financijama	financije	Ncfpi
.	.	Z

Ključni	ključan	Agpmsny
korupcijski	korupcijski	Agpmsny
rizik	rizik	Ncmsn
za	za	Sa
osiguranje	osiguranje	Ncnsa
učinkovitog	učinkovit	Agpnsgy
upravljanja	upravljanje	Ncnsg
javnim	javan	Agpfpiy
financijama	financije	Ncfpi
je	biti	Var3s
u	u	Sl
nedostatku	nedostatak	Ncmsl
specijaliziranih	specijaliziran	Agpnpgy
znanja	znanje	Ncnpg
i	i	Cc
nedostatnom	nedostatan	Agpnsly
stručnom	stručan	Agpnsly
usavršavanju	usavršavanje	Ncnsl
inspektora	inspektor	Ncmpg
i	i	Cc
osoba	osoba	Ncfpg
odgovornih	odgovoran	Agpfpgy
za	za	Sa
financijsko	financijski	Agpnsay
upravljanje	upravljanje	Ncnsa
i	i	Cc
kontrole	kontrola	Ncfsg
.	.	Z

Osim	osim	Sg
toga	taj	Pd-nsg
,	,	Z
neophodno	neophodan	Agpnsny
je	biti	Var3s
poduzimanje	poduzimanje	Ncnsn
mjera	mjera	Ncfpg
kojima	koji	Pi-fpd
će	htjeti	Var3s
se	sebe	Px--sa
osigurati	osigurati	Vmn
učinkovito	učinkovit	Agpnsay
upravljanje	upravljanje	Ncnsa
javnim	javan	Agpfpiy
financijama	financije	Ncfpi
,	,	Z
potpuna	potpun	Agpfsny
i	i	Cc
učinkovita	učinkovit	Agpfsny
naplata	naplata	Ncfsn
prihoda	prihod	Ncmpg
iz	iz	Sg
nadležnosti	nadležnost	Ncfsg
proračunskih	proračunski	Agpmpgy
korisnika	korisnik	Ncmpg
i	i	Cc
tijela	tijelo	Ncnsg
jedinica	jedinica	Ncfpg
lokalne	lokalan	Agpfsgy
i	i	Cc
područne	područni	Agpfsgy
(	(	Z
regionalne	regionalan	Agpfpay
)	)	Z
samouprave	samouprava	Ncfsg
te	te	Cc
nadzor	nadzor	Ncmsan
zakonitosti	zakonitost	Ncfsg
korištenja	korištenje	Ncnsg
proračunskih	proračunski	Agpnpgy
sredstava	sredstvo	Ncnpg
.	.	Z

Značajna	značajan	Agpfsny
autonomija	autonomija	Ncfsn
u	u	Sl
postupanju	postupanje	Ncnsl
inspektora	inspektor	Ncmsg
otvara	otvarati	Vmr3s
prostor	prostor	Ncmsan
za	za	Sa
koruptivno	koruptivan	Agpnsay
djelovanje	djelovanje	Ncnsa
koje	koji	Pi-nsn
treba	trebati	Vmr3s
prevenirati	prevenirati	Vmn
mjerama	mjera	Ncfpi
smanjivanja	smanjivanje	Ncnsg
autonomnih	autonoman	Agpfpgy
diskrecijskih	diskrecijski	Agpfpgy
odluka	odluka	Ncfpg
te	te	Cc
jačanja	jačanje	Ncnsg
kontrolnih	kontrolan	Agpmpgy
mehanizama	mehanizam	Ncmpg
i	i	Cc
praćenja	praćenje	Ncnsg
rada	rad	Ncmsg
.	.	Z

Neprovođenje	neprovođenje	Ncnsn
i	i	Cc
/	/	Z
ili	ili	Cc
neadekvatna	neadekvatan	Agpfsny
procjena	procjena	Ncfsn
rizika	rizik	Ncmpg
poslovanja	poslovanje	Ncnsg
sektorskih	sektorski	Agpmpgy
obveznika	obveznik	Ncmpg
,	,	Z
njihovih	njihov	Ps3mpg
klijenata	klijent	Ncmpg
,	,	Z
proizvoda	proizvod	Ncmpg
i	i	Cc
usluga	usluga	Ncfpg
rezultira	rezultirati	Vmr3s
neadekvatnom	neadekvatan	Agpfsiy
provedbom	provedba	Ncfsi
nadzornih	nadzorni	Agpmpgy
i	i	Cc
supervizijskih	supervizijski	Agpfpgy
mjera	mjera	Ncfpg
.	.	Z

Mogući	moguć	Agpmpny
oblici	oblik	Ncmpn
zlouporaba	zlouporaba	Ncfpg
ovlasti	ovlast	Ncfsg
,	,	Z
pogodovanja	pogodovanje	Ncnsg
i	i	Cc
neprovođenja	neprovođenje	Ncnsg
zakona	zakon	Ncmsg
u	u	Sl
poreznom	porezni	Agpmsly
sustavu	sustav	Ncmsl
upućuju	upućivati	Vmr3p
prije	prije	Sg
svega	sav	Pi-nsg
na	na	Sa
potrebu	potreba	Ncfsa
jačanja	jačanje	Ncnsg
temeljnih	temeljan	Agpmpgy
mehanizama	mehanizam	Ncmpg
za	za	Sa
suzbijanje	suzbijanje	Ncnsa
korupcije	korupcija	Ncfsg
kroz	kroz	Sa
daljnji	daljnji	Agpmsayn
razvoj	razvoj	Ncmsan
i	i	Cc
implementaciju	implementacija	Ncfsa
projekta	projekt	Ncmsg
eOvrha	eOvrh	Npmsg
za	za	Sa
pravodobno	pravodoban	Agpnsay
i	i	Cc
ujednačeno	ujednačiti	Agpnsay
postupanje	postupanje	Ncnsa
prema	prema	Sl
dužnicima	dužnik	Ncmpl
,	,	Z
daljnju	daljnji	Agpfsay
informatizaciju	informatizacija	Ncfsa
i	i	Cc
razradu	razrada	Ncfsa
metodologija	metodologija	Ncfsn
poreznog	porezni	Agpmsgy
nadzora	nadzor	Ncmsg
te	te	Cc
reviziju	revizija	Ncfsa
ovlaštenja	ovlaštenje	Ncnsg
za	za	Sa
pristup	pristup	Ncmsan
Informacijskom	informacijski	Agpmsdy
sustavu	sustav	Ncmsd
Porezne	porezni	Agpfsgy
uprave	uprava	Ncfsg
.	.	Z

Osim	osim	Sg
toga	taj	Pd-nsg
,	,	Z
nužno	nužan	Agpnsny
je	biti	Var3s
unaprjeđenje	unaprjeđenje	Ncnsn
komunikacije	komunikacija	Ncfsg
Porezne	porezni	Agpfsgy
uprave	uprava	Ncfsg
s	sa	Si
poreznim	porezni	Agpmpiy
obveznicima	obveznik	Ncmpi
radi	radi	Sg
zajedničkog	zajednički	Agpmsgy
doprinosa	doprinos	Ncmsg
borbi	borba	Ncfpg
protiv	protiv	Sg
korupcije	korupcija	Ncfsg
i	i	Cc
uspostave	uspostava	Ncfsg
uzajamnog	uzajaman	Agpnsgy
povjerenja	povjerenje	Ncnsg
osiguravanjem	osiguravanje	Ncnsi
dostupnosti	dostupnost	Ncfsg
svih	sav	Agpfpgy
potrebnih	potreban	Agpfpgy
informacija	informacija	Ncfpg
provođenjem	provođenje	Ncnsi
edukativnih	edukativan	Agpfpgy
kampanja	kampanja	Ncfpg
o	o	Sl
promjenama	promjena	Ncfpl
u	u	Sl
poreznom	porezni	Agpmsly
sustavu	sustav	Ncmsl
.	.	Z

Napokon	napokon	Rgp
,	,	Z
u	u	Sl
spomenutom	spomenuti	Agpmsly
okviru	okvir	Ncmsl
potrebno	potreban	Agpnsny
je	biti	Var3s
predvidjeti	predvidjeti	Vmn
i	i	Cc
snažnije	snažan	Agcmpay
mehanizme	mehanizam	Ncmpa
međuinstitucionalne	međuinstitucionalan	Agpfsgy
suradnje	suradnja	Ncfsg
Porezne	porezni	Agpfsgy
uprave	uprava	Ncfsg
na	na	Sl
suzbijanju	suzbijanje	Ncnsl
korupcije	korupcija	Ncfsg
u	u	Sl
razvijanju	razvijanje	Ncnsl
standardiziranih	standardiziran	Agpfpgy
procedura	procedura	Ncfpg
i	i	Cc
unaprjeđenju	unaprjeđenje	Ncnsl
tehničkih	tehnički	Agpfpgy
mogućnosti	mogućnost	Ncfpg
za	za	Sa
razmjenu	razmjena	Ncfsa
podataka	podatak	Ncmpg
s	sa	Si
drugim	drugi	Mlompi
tijelima	tijelo	Ncmpi
(	(	Z
DORH	DORH	Npmsn
,	,	Z
MUP	MUP	Npmsn
,	,	Z
Ured	ured	Ncmsn
za	za	Sa
sprječavanje	sprječavanje	Ncnsa
pranja	pranje	Ncnsg
novca	novac	Ncmsg
)	)	Z
.	.	Z

Ključne	ključan	Agpmpay
koruptivne	koruptivan	Agpmpay
potencijale	potencijal	Ncmpa
u	u	Sl
djelovanju	djelovanje	Ncnsl
Carinske	carinski	Agpfsgy
uprave	uprava	Ncfsg
predstavljaju	predstavljati	Vmr3p
nedovoljno	nedovoljno	Rgp
definirane	definirati	Appfpny
i	i	Cc
nejasne	nejasan	Agpfpny
smjernice	smjernica	Ncfpn
za	za	Sa
provedbu	provedba	Ncfsa
određenih	određen	Agpmpgy
članaka	članak	Ncmpg
carinskih	carinski	Agpnpgy
i	i	Cc
trošarinskih	trošarinski	Agpmpgy
propisa	propis	Ncmpg
nužne	nužan	Agpfpny
za	za	Sa
smanjivanje	smanjivanje	Ncnsa
diskrecijskog	diskrecijski	Agpnsgy
prava	pravo	Ncnsg
carinskog	carinski	Agpmsgy
službenika	službenik	Ncmsg
odnosno	odnosno	Rgp
mogućnosti	mogućnost	Ncfpg
proizvoljne	proizvoljan	Agpfsgy
i	i	Cc
neujednačene	neujednačen	Agpfpay
primjene	primjena	Ncfpa
propisa	propis	Ncmpg
s	sa	Si
ciljem	cilj	Ncmsi
protupravnog	protupravan	Agpnsgy
stjecanja	stjecanje	Ncnsg
imovinske	imovinski	Agpfsgy
ili	ili	Cc
neimovinske	neimovinski	Agpfsgy
koristi	korist	Ncfsg
,	,	Z
etički	etički	Agpmsny
nepoželjno	nepoželjan	Agpnsay
ponašanje	ponašanje	Ncnsa
te	te	Cc
nedovoljna	nedovoljan	Agpfsny
educiranost	educiranost	Ncfsn
službenika	službenik	Ncmpg
u	u	Sl
odnosu	odnos	Ncmsl
na	na	Sa
proširenu	proširiti	Ncmsl
nadležnost	nadležnost	Ncfsa
Carinske	carinski	Agpfsgy
uprave	uprava	Ncfsg
.	.	Z

Ostvarenje	ostvarenje	Ncnsn
željene	željeti	Agpfsgy
razine	razina	Ncfsg
učinkovitosti	učinkovitost	Ncfsg
,	,	Z
djelotvornosti	djelotvornost	Ncfsg
i	i	Cc
transparentnosti	transparentnost	Ncfsg
carinskog	carinski	Agpmsgy
sustava	sustav	Ncmsg
,	,	Z
za	za	Sa
uspostavu	uspostava	Ncfsa
učinkovitijeg	učinkovit	Agcmsgy
unutarnjeg	unutarnji	Agpmsgy
nadzora	nadzor	Ncmsg
i	i	Cc
kontrole	kontrola	Ncfsg
,	,	Z
s	sa	Si
konačnim	konačan	Agpmsiy
ciljem	cilj	Ncmsi
sustavnog	sustavan	Agpnsgy
sužavanja	sužavanje	Ncnsg
prostora	prostor	Ncmsg
za	za	Sa
pojavu	pojava	Ncfsa
korupcije	korupcija	Ncfsg
,	,	Z
zahtijeva	zahtijevati	Vmr3s
standardizaciju	standardizacija	Ncfsa
carinskih	carinski	Agpmpgy
postupaka	postupak	Ncmpg
i	i	Cc
procedura	procedura	Ncfpg
,	,	Z
unaprjeđenja	unaprjeđenje	Ncnsg
Etičkog	etički	Agpmsgy
kodeksa	kodeks	Ncmsg
i	i	Cc
disciplinskog	disciplinski	Agpmsgy
sustava	sustav	Ncmsg
,	,	Z
daljnje	daljnji	Agpfsgy
edukacije	edukacija	Ncfsg
službenika	službenik	Ncmpg
vezanih	vezan	Agpmpgy
uz	uz	Sa
primjenu	primjena	Ncfsa
ovlasti	ovlast	Ncfsg
i	i	Cc
mogući	moguć	Agpmsny
sukob	sukob	Ncmsn
interesa	interes	Ncmsg
.	.	Z

Nadalje	nadalje	Rgp
,	,	Z
daljnjim	daljnji	Agpmsiy
razvojem	razvoj	Ncmsi
informacijskih	informacijski	Agpfpgy
tehnologija	tehnologija	Ncfpg
u	u	Sl
carinskim	carinski	Agpmply
postupcima	postupak	Ncmpl

moguće	moguć	Agpnsny
je	biti	Var3s
kvalitetnije	kvalitetno	Rgc
upravljati	upravljati	Vmn
korupcijskim	korupcijski	Agpmpiy
rizicima	rizik	Ncmpi
zlouporabe	zlouporaba	Ncfsg
povjerljivih	povjerljiv	Agpfpgy
informacija	informacija	Ncfpg
,	,	Z
omogućujući	omogućivati	Rr
daljnje	daljnji	Agpnsay
olakšavanje	olakšavanje	Ncnsa
carinskih	carinski	Agpmpgy
postupaka	postupak	Ncmpg
i	i	Cc
kontrola	kontrola	Ncfpg
u	u	Sl
međunarodnoj	međunarodni	Agpfsly
robnoj	roban	Agpfsly
razmjeni	razmjena	Ncfsl
,	,	Z
sustavno	sustavno	Rgp
smanjiti	smanjiti	Vmn
mogućnost	mogućnost	Ncfsa
pojave	pojava	Ncfsg
korupcije	korupcija	Ncfsg
.	.	Z

CILJ	cilj	Ncmsn
:	:	Z
Jačanje	jačanje	Ncnsn
integriteta	integritet	Ncmsg
,	,	Z
odgovornosti	odgovornost	Ncfsg
i	i	Cc
transparentnosti	transparentnost	Ncfsg
unutar	unutar	Sg
sustava	sustav	Ncmsg
javnih	javan	Agpfpgy
financija	financije	Ncfpg

MJERE	mjera	Ncfpn
:	:	Z

1.	1.	Mdo
Učinkovito	učinkovit	Agpnsny
upravljanje	upravljanje	Ncnsn
i	i	Cc
kontrola	kontrola	Ncfpg
javnih	javan	Agpfpgy
financija	financije	Ncfpg
i	i	Cc
učinkovita	učinkovit	Agpfsny
naplata	naplata	Ncfsn
prihoda	prihod	Ncmpg
iz	iz	Sg
nadležnosti	nadležnost	Ncfsg
proračunskih	proračunski	Agpmpgy
korisnika	korisnik	Ncmpg
i	i	Cc
jedinica	jedinica	Ncfpg
lokalne	lokalan	Agpfsgy
i	i	Cc
područne	područni	Agpfsgy
(	(	Z
regionalne	regionalan	Agpfpay
)	)	Z
samouprave	samouprava	Ncfsg
te	te	Cc
zakonitost	zakonitost	Ncfsn
korištenja	korištenje	Ncnsg
proračunskih	proračunski	Agpnpgy
sredstava	sredstvo	Ncnpg

2.	2.	Mdo
Jačanje	jačanje	Ncnsn
administrativnih	administrativan	Agpmpgy
kapaciteta	kapacitet	Ncmpg
zaposlenika	zaposlenik	Ncmpg
Ministarstva	ministarstvo	Ncnsg
financija	financije	Ncfpg

3.	3.	Mdo
Jačanje	jačanje	Ncnsn

