28	28	Mdc
13.03.2015	13.03.2015	Mdc
Izmjene	izmjena	Ncfsg
i	i	Cc
dopune	dopuna	Ncfsg
Metodologije	metodologija	Ncfsg
utvrđivanja	utvrđivanje	Ncnsg
iznosa	iznos	Ncmsg
tarifnih	tarifan	Agpfpgy
stavki	stavka	Ncfpg
za	za	Sa
javnu	javan	Agpfsay
uslugu	usluga	Ncfsa
opskrbe	opskrba	Ncfsg
plinom	plin	Ncmsi
i	i	Cc
zajamčenu	zajamčiti	Agpfsay
opskrbu	opskrba	Ncfsa

HRVATSKA	hrvatski	Agpfsny
ENERGETSKA	energetski	Agpfsny
REGULATORNA	regulatoran	Agpfsny
AGENCIJA	agencija	Ncfsn

596	596	Mdc

Na	na	Sl
temelju	temelj	Ncmsl
članka	članak	Ncmsg
11.	11.	Mdo
stavka	stavak	Ncmsg
1.	1.	Mdo
točke	točka	Ncfsg
9.	9.	Mdo
Zakona	zakon	Ncmsg
o	o	Sl
regulaciji	regulacija	Ncfsl
energetskih	energetski	Agpfpgy
djelatnosti	djelatnost	Ncfpg
(	(	Z
»	»	Z
Narodne	narodni	Agpfpny
novine	novina	Ncfpn
«	«	Z
,	,	Z
broj	broj	Ncmsn
120/12	120/12	Mds
)	)	Z
,	,	Z
Hrvatska	Hrvatska	Npfsn
energetska	energetski	Agpfsny
regulatorna	regulatoran	Agpfsny
agencija	agencija	Ncfsn
je	biti	Var3s
na	na	Sl
sjednici	sjednica	Ncfsl
Upravnog	upravan	Agpnsgy
vijeća	vijeće	Ncnsg
održanoj	održati	Appfsly
10.	10.	Mdo
ožujka	ožujak	Ncmsg
2015.	2015.	Mdo
donijela	donijeti	Vmp-sf

IZMJENE	izmjena	Ncfpn
I	i	Cc
DOPUNE	dopuna	Ncfsg
METODOLOGIJE	metodologija	Ncfsg
UTVRĐIVANJA	utvrđivanje	Ncnsg
IZNOSA	iznos	Ncmsg
TARIFNIH	tarifan	Agpfpgy
STAVKI	stavka	Ncfpg
ZA	za	Sa
JAVNU	javan	Agpfsay
USLUGU	usluga	Ncfsa
OPSKRBE	opskrba	Ncfsg
PLINOM	plin	Ncmsi
I	i	Cc
ZAJAMČENU	zajamčiti	Agpfsay
OPSKRBU	opskrba	Ncfsa

