34	34	Mdc
25.03.2015	25.03.2015	Mdo
Odluka	odluka	Ncfsn
o	o	Sl
imenovanju	imenovanje	Ncnsl
člana	član	Ncmsg
Upravnog	upravan	Agpnsgy
vijeća	vijeće	Ncnsg
Hrvatske	hrvatski	Agpfsgy
izvještajne	izvještajni	Agpfsgy
novinske	novinski	Agpfsgy
agencije	agencija	Ncfsg

HRVATSKI	hrvatski	Agpmsny
SABOR	sabor	Ncmsn

702	702	Mdc

Na	na	Sl
temelju	temelj	Ncmsl
članka	članak	Ncmsg
81.	81.	Mdo

Ustava	ustava	Ncfsn
Republike	republika	Ncfsg
Hrvatske	Hrvatska	Npfsg
i	i	Cc
članka	članak	Ncmsg
11.	11.	Mdo
stavka	stavak	Ncmsg
1.	1.	Mdo
Zakona	zakon	Ncmsg
o	o	Sl
Hrvatskoj	Hrvatska	Npfsl
izvještajnoj	izvještajni	Agpfsly
novinskoj	novinski	Agpfsly
agenciji	agencija	Ncfsl
(	(	Z
»	»	Z
Narodne	narodni	Agpfpny
novine	novina	Ncfpn
«	«	Z
,	,	Z
br.	br.	Y
96/01.	96/01.	Mdo
)	)	Z
Hrvatski	hrvatski	Agpmsny
sabor	sabor	Ncmsn
na	na	Sl
sjednici	sjednica	Ncfsl
20.	20.	Mdo
ožujka	ožujak	Ncmsg
2015.	2015.	Mdo
donio	donijeti	Vmp-sm
je	biti	Var3s

ODLUKU	odluka	Ncfsa

O	o	Sl
IMENOVANJU	imenovanje	Ncnsl
ČLANA	član	Ncmsg
UPRAVNOG	upravan	Agpnsgy
VIJEĆA	vijeće	Ncnsg
HRVATSKE	hrvatski	Agpfsgy
IZVJEŠTAJNE	izvještajni	Agpfsgy
NOVINSKE	novinski	Agpfsgy
AGENCIJE	agencija	Ncfsg

Imenuje	imenovati	Vmr3s
se	sebe	Px--sa
VLADIMIR	Vladimir	Npmsn
LULIĆ	LULIĆ	Npmsn
članom	član	Ncmsi
Upravnog	upravan	Agpnsgy
vijeća	vijeće	Ncnsg
Hrvatske	hrvatski	Agpfsgy
izvještajne	izvještajni	Agpfsgy
novinske	novinski	Agpfsgy
agencije	agencija	Ncfsg
,	,	Z
iz	iz	Sg
reda	red	Ncmsg
stručnjaka	stručnjak	Ncmpg
za	za	Sa
medije	medij	Ncmpa
.	.	Z

Klasa	klasa	Ncfsn
:	:	Z
021	021	Mdc
-	-	Z
13/15	13/15	Mdc
-	-	Z
07/11	07/11	Mdc

Zagreb	Zagreb	Npmsn
,	,	Z
20.	20.	Mdo
ožujka	ožujak	Ncmsg
2015.	2015.	Mdo

HRVATSKI	hrvatski	Agpmsny
SABOR	sabor	Ncmsn

Predsjednik	predsjednik	Ncmsn
Hrvatskoga	hrvatski	Agpmsgy
sabora	sabor	Ncmsg
Josip	Josip	Npmsn
Leko	Leko	Npmsn
,	,	Z
v.	v.	Y
r.	r.	Y

