povreda	povreda	Ncfsn
ustavnih	ustavan	Agpnpgy
prava	pravo	Ncnpg
zajamčenih	zajamčiti	Appnpgy
člankom	članak	Ncmsi
29.	29.	Mdo
stavkom	stavak	Ncmsi
1.	1.	Mdo
Ustava	ustav	Ncmsg
,	,	Z
Ustavni	ustavan	Agpmsny
sud	sud	Ncmsn
nije	biti	Var3s
smatrao	smatrati	Vmp-sm
potrebnim	potreban	Agpmsiy
razmatrati	razmatrati	Vmn
povredu	povreda	Ncfsa
ustavnog	ustavan	Agpnsgy
prava	pravo	Ncnsg
zajamčenog	zajamčiti	Appnsgy
člankom	članak	Ncmsi
14.	14.	Mdo
stavkom	stavak	Ncmsi
2.	2.	Mdo
Ustava	ustav	Ncmsg
,	,	Z
na	na	Sa
koju	koji	Pi-fsa
podnositelj	podnositelj	Ncmsn
ukazuje	ukazivati	Vmr3s
,	,	Z
jer	jer	Cs
je	biti	Var3s
riječ	riječ	Ncfsn
o	o	Sl
istovjetnim	istovjetan	Agpmply
razlozima	razlog	Ncmpl
.	.	Z

15.	15.	Mdo

Slijedom	slijed	Sg
svega	sav	Agpnsgy
navedenog	naveden	Agpnsgy
,	,	Z
a	a	Cc
na	na	Sl
temelju	temelj	Ncmsl
članka	članak	Ncmsg
76.	76.	Mdo
stavka	stavak	Ncmsg
3.	3.	Mdo
Ustavnog	ustavan	Agpmsgy
zakona	zakon	Ncmsg
,	,	Z
odlučeno	odlučiti	Appnsny
je	biti	Var3s
kao	kao	Cs
u	u	Sl
izreci	izreka	Ncfsl
.	.	Z

16.	16.	Mdo

Objava	objava	Ncfsn
ove	ovaj	Pd-fsg
odluke	odluka	Ncfsg
temelji	temeljiti	Vmr3s
se	sebe	Px--sa
na	na	Sl
članku	članak	Ncmsl
29.	29.	Mdo

Ustavnog	ustavan	Agpmsgy
zakona	zakon	Ncmsg
.	.	Z

Broj	broj	Ncmsn
:	:	Z
U-III-5656	U-III-5656	X
/	/	Z
2012	2012	Mdc
Zagreb	Zagreb	Npmsn
,	,	Z
19.	19.	Mdo
ožujka	ožujak	Ncmsg
2015.	2015.	Mdo

USTAVNI	ustavan	Agpmsny
SUD	sud	Ncmsn
REPUBLIKE	republika	Ncfsg
HRVATSKE	hrvatski	Agpfsgy

Predsjednica	predsjednica	Ncfsn
Vijeća	vijeće	Ncnsg
dr.	dr.	Y
sc.	sc.	Y
Snježana	Snježana	Npfsn
Bagić	Bagić	Npfsn
,	,	Z
v.	v.	Y
r.	r.	Y

