Članak	članak	Ncmsn
4.	4.	Mdo

Ovaj	ovaj	Pd-msn
Sporazum	sporazum	Ncmsn
stupa	stupati	Vmr3s
na	na	Sa
snagu	snaga	Ncfsa
danom	dan	Agpnsly
potpisa	potpis	Ncmsg
,	,	Z
sastavni	sastavan	Agpmsny
je	biti	Var3s
dio	dio	Ncmsn
teksta	tekst	Ncmsg
Kolektivnog	kolektivan	Agpmsgy
ugovora	ugovor	Ncmsg
iz	iz	Sg
kojega	koji	Ncmsg
proizlaze	proizlaziti	Vmr3p
pravna	pravni	Agpnpny
pravila	pravilo	Ncnpn
a	a	Cc
pravila	pravilo	Ncnpg
iz	iz	Sg
čl.	čl.	Y
2.	2.	Mdo
Ovog	ovaj	Pd-msg
Sporazuma	sporazum	Ncmsg
primjenjuju	primjenjivati	Vmr3p
se	sebe	Px--sa
od	od	Sg
1.	1.	Mdo
1.	1.	Mdo
2015.	2015.	Mdo
godine	godina	Ncfsg
.	.	Z

ZA	za	Sa
NEZAVISNI	nezavisan	Agpmsayn
CESTARSKI	cestarski	Agpmsayn
SINDIKAT	sindikat	Ncmsan
Mijat	Mijat	Npmsn
Stanić	Stanić	Npmsn
,	,	Z
predsjednik	predsjednik	Ncmsn
,	,	Z
v.	v.	Y
r.	r.	Y
ZA	za	Sa
AUTOCESTU	autocesta	Ncfsa
RIJEKA	Rijeka	Npfsn
–	–	Z
ZAGREB	Zagreb	Npmsn
d.	d.	Y
d.	d.	Y
Josip	Josip	Npmsn
Šala	Šala	Npmsn
,	,	Z
predsjednik	predsjednik	Ncmsn
Uprave	uprava	Ncfsg
,	,	Z
v.	v.	Y
r.	r.	Y

