POTREBE	potreba	Ncfpn
SASTAVLJANJA	sastavljanje	Ncnsg
PLATNE	platni	Agpfsgy
BILANCE	bilanca	Ncfsg
,	,	Z
STANJA	stanje	Ncnsg
INOZEMNOG	inozeman	Agpmsgy
DUGA	dug	Ncmsg
I	i	Cc
STANJA	stanje	Ncnsg
MEĐUNARODNIH	međunarodni	Agpnpgy
ULAGANJA	ulaganje	Ncnpg
KOJA	koji	Pi-npn
SE	sebe	Px--sa
HRVATSKOJ	Hrvatska	Npfsd
NARODNOJ	narodni	Agpfsly
BANCI	banka	Ncfsl
DOSTAVLJAJU	dostavljati	Vmr3p
U	u	Sl
PAPIRNATOM	papirnat	Agpmsly
OBLIKU	oblik	Ncmsl

