člana	član	Ncmsay
Državnog	državni	Agpnsgy
sudbenog	sudbeni	Agpnsgy
vijeća	vijeće	Ncnsg
dobio	dobiti	Vmp-sm
više	mnogo	Rgc
glasova	glas	Ncmpg
od	od	Sg
njega	njega	Ncfpg
,	,	Z
ako	ako	Cs
je	biti	Var3s
do	do	Sg
eliminacije	eliminacija	Ncfsg
tog	taj	Pd-msg
kandidata	kandidat	Ncmsg
došlo	doći	Vmp-sn
zbog	zbog	Sg
kršenja	kršenje	Ncnsg
Ustava	ustav	Ncmsg
.	.	Z

Tu	taj	Pd-fsa
pravnu	pravni	Agpfsay
konstrukciju	konstrukcija	Ncfsa
nije	biti	Var3s
potrebno	potreban	Agpnsny
razmatrati	razmatrati	Vmn
ni	ni	Qo
u	u	Sl
ovom	ovaj	Pd-msl
postupku	postupak	Ncmsl
,	,	Z
budući	budući	Cs
da	da	Cs
okolnosti	okolnost	Ncfpn
konkretnog	konkretan	Agpmsgy
slučaja	slučaj	Ncmsg
upućuju	upućivati	Vmr3p
na	na	Sa
zaključak	zaključak	Ncmsan
da	da	Cs
do	do	Sg
kršenja	kršenje	Ncnsg
članka	članak	Ncmsg
121.	121.	Mdo
stavka	stavak	Ncmsg
8.	8.	Mdo
Ustava	ustava	Ncfsn
nije	biti	Var3s
došlo	doći	Vmp-sn
.	.	Z

U	u	Sa
tim	tim	Ncmsan
su	biti	Var3p
okvirima	okvir	Ncmpl
za	za	Sa
Ustavni	ustavan	Agpmsayn
sud	sud	Ncmsan
važniji	važan	Agcmpny
zahtjevi	zahtjev	Ncmpn
koji	koji	Pi-mpn
proizlaze	proizlaziti	Vmr3p
iz	iz	Sg
tumačenja	tumačenje	Ncnsg
članka	članak	Ncmsg
121.	121.	Mdo
stavka	stavak	Ncmsg
8.	8.	Mdo
Ustava	ustav	Ncmsg
kakvo	kakav	Appmpny
su	biti	Var3p
u	u	Sl
slučaju	slučaj	Ncmsl
suca	sudac	Ncmsg
Nediljka	Nediljk	Npmsg
Bobana	Boban	Npmsg
dali	dati	Vmp-pm
Povjerenstvo	povjerenstvo	Ncnsa
za	za	Sa
izbor	izbor	Ncmsan
članova	član	Ncmpg
Državnog	državni	Agpnsgy
sudbenog	sudbeni	Agpnsgy
vijeća	vijeće	Ncnsg
i	i	Cc
Vijeće	vijeće	Ncnsa
Vrhovnog	vrhovni	Agpmsgy
suda	sud	Ncmsg
.	.	Z

Naime	naime	Qo
,	,	Z
to	taj	Pd-nsn
tumačenje	tumačenje	Ncnsn
obvezuje	obvezivati	Vmr3s
nadležna	nadležan	Agpnpay
tijela	tijelo	Ncnpa
da	da	Cs
u	u	Sl
svim	sav	Agpfply
drugim	drugi	Mlofpl
sličnim	sličan	Agpfply
(	(	Z
usporedivim	usporediv	Agpmply
)	)	Z
slučajevima	slučaj	Ncmpl
,	,	Z
koji	koji	Pi-mpn
bi	biti	Vaa3p
se	sebe	Px--sa
eventualno	eventualno	Rgp
mogli	moći	Vmp-pm
pojaviti	pojaviti	Vmn
u	u	Sl
praksi	praksa	Ncfsl
,	,	Z
poštuju	poštovati	Vmr3p
načela	načelo	Ncnpn
koja	koji	Pi-npn
su	biti	Var3p
sami	sam	Agpmpny
izgradili	izgraditi	Vmp-pm
u	u	Sl
slučaju	slučaj	Ncmsl
suca	sudac	Ncmsg
Nediljka	Nediljk	Npmsg
Bobana	Boban	Npmsg
.	.	Z

Taj	taj	Pd-msn
zahtjev	zahtjev	Ncmsn
proizlazi	proizlaziti	Vmr3s
iz	iz	Sg
vladavine	vladavina	Ncfsg
prava	pravo	Ncnsg
,	,	Z
najviše	mnogo	Rgs
vrednote	vrednota	Ncfsg
ustavnog	ustavan	Agpmsgy
poretka	poredak	Ncmsg
Republike	republika	Ncfsg
Hrvatske	Hrvatska	Npfsg
,	,	Z
a	a	Cc
osobito	osobito	Rgp
iz	iz	Sg
načela	načelo	Ncnsg
pravne	pravni	Agpfsgy
sigurnosti	sigurnost	Ncfsg
,	,	Z
pravne	pravni	Agpfsgy
izvjesnosti	izvjesnost	Ncfsg
i	i	Cc
pravne	pravni	Agpfsgy
predvidljivosti	predvidljivost	Ncfsg
.	.	Z

Poštovanje	poštovanje	Ncnsn
tog	taj	Pd-msg
zahtjeva	zahtjev	Ncmsg
podliježe	podlijegati	Vmr3s
nadzoru	nadzor	Ncmsd
Ustavnog	ustavan	Agpmsgy
suda	sud	Ncmsg
.	.	Z

23.	23.	Mdo

Iz	iz	Sg
navedenih	naveden	Agpmpgy
razloga	razlog	Ncmpg
,	,	Z
Ustavni	ustavan	Agpmsny
sud	sud	Ncmsn
je	biti	Var3s
na	na	Sl
temelju	temelj	Ncmsl
članaka	članak	Ncmpg
32.	32.	Mdo

Ustavnog	ustavan	Agpmsgy
zakona	zakon	Ncmsg
odbacio	odbaciti	Vmp-sm
prigovore	prigovor	Ncmpa
podnositelja	podnositelj	Ncmpg
o	o	Sl
povredi	povreda	Ncfsl
članka	članak	Ncmsg
121.	121.	Mdo
stavka	stavak	Ncmsg
8.	8.	Mdo
Ustava	ustav	Ncmsg
te	te	Cc
je	biti	Var3s
riješio	riješiti	Vmp-sm
kao	kao	Cs
u	u	Sl
točki	točka	Ncfsl
I.	ii	Agpfpay
izreke	izreka	Ncfpa
ovog	ovaj	Pd-nsg
rješenja	rješenje	Ncnsg
.	.	Z

24.	24.	Mdo

Objava	objava	Ncfsn
ovog	ovaj	Agpnsgy
rješenja	rješenje	Ncnsg
temelji	temeljiti	Vmr3s
se	sebe	Px--sa
na	na	Sl
članku	članak	Ncmsl
29.	29.	Mdo

Ustavnog	ustavan	Agpmsgy
zakona	zakon	Ncmsg
.	.	Z

Broj	broj	Ncmsn
:	:	Z
U-III-930	U-III-930	Mds
/	/	Z
2015	2015	Mdc

Zagreb	Zagreb	Npmsn
,	,	Z
31.	31.	Mdo
ožujka	ožujak	Ncmsg
2015.	2015.	Mdo

Predsjednik	predsjednik	Ncmsn
Vijeća	vijeće	Ncnsg
dr.	dr.	Y
sc.	sc.	Y
Mato	Mato	Npmsn
Arlović	Arlović	Npmsn
,	,	Z
v.	v.	Y
r.	r.	Y

