 6.12. Valerianella locusta L. Laterr Matovilac Accent EZBnl ZH 6.13. Daucus carota L. ssp. sativus (Hoffm.) Arcang Mrkva Laguna NBnl PV 6.14. Capsicum annuum L. var. grossum Sendt.– Paprika Atris NBnl PV Bianca EZBnl ZH Kaldom ŠA Palanačka Babura ZH Pirouet AF Vedrana ZH 6.15. Lycopersicon esculentum Mill Rajčica Amaneta EZBnl ZH Axel ESit Phr Belle ZH Berberana EZBnl ZH Bobcat AF Buran ZH Dirk EZBnl ZH Fabiola GSNfr ZH Heinz2206 HDsad Phr Heinz3402 HDsad Phr Heinz9144 Phr Minaret SyNL AF Ombelline AF Rally ZH Sakura EZBnl ZH Sprinter NBnl PV Sunstream EZBnl ZH Wally Red ESit Phr 6.16. Raphanus sativus L. var. radicula DC. Rotkvica Celesta EZBnl ZH Rudi ZH Tarzan EZBnl ZH 6.17. Lactuca sativa L. Salata Analena EZBnl ZH Beldy EZBnl ZH Bonaly EZBnl ZH Caipira EZBnl ZH Flavy EZBnl ZH Follomy EZBnl ZH Friendy EZBnl ZH Maditta EZBnl ZH Maritima EZBnl ZH Tatiana EZBnl ZH Vanity EZBnl ZH 6.18. Spinacea oleracea L. Špinat Yabi EZBnl ZH
LEGENDA NAZIVA I SJEDIŠTA PUNOMOĆNIKA I PODNOSITELJA
RWA – RWA Raiffeisen Agro d.o.o., Zagreb (HR)
SyA – Syngenta Agro d.o.o., Zagreb (HR)
MCO – Mladen Commerce d.o.o. (HR)
Po – Poljoopskrba međunarodna trgovina d.o.o., Zagreb (HR)
PIO – Poljoprivredni institut Osijek, Osijek (HR)
KWS – KWS Sjeme d.o.o., Požega (HR)
SZg – Sjemenarna Zagreb d.o.o. (HR)
PS Pioneer Sjeme d.o.o., Zagreb
Age – Agrigenetics d.o.o. (HR)
JSI Jost Sjeme-istraživanja d.o.o. (HR)p
SE – Sedlaček d.o.o. (HR)
ŠA – Šafram d.o.o. (HR)
PV-Poljovrt d.o.o. (HR)
AF – Adriaflora d.o.o. (HR)
Phr Podravka d.d., Koprivnica
ZH Zeleni hit d.o.o., Zagreb (HR)
KWSde – KWS SAAT AG (DE)
NBnl – Nunhems BV (NL)
SyNL – Syngenta Seeds B.V. (NL)
GSNfr – GSN Semences (FR)
CSfr Caussade semences (FR)
ESfr Euralis Semences (FR)
MonsDE – Monsanto Saaten GmbH (DE)
MonsHU – Monsanto Hungaria Kft. (HU)
NPHde – Norddeutsche Pflanzenzucht Hans Georg Lembke KG (DE)
SDGat – Saatzucht Donau GesmbH& CoKG, Probstdorf (AT)
LVfr – Limagrain Verneuil Holding (FR)
TEnl – Takii Europe B.V. (NL)
HDsad – Heinz Seed (USA)
ESit – ESASEM S.p.A. (IT)
EZBnl – Enza Zaden Beheer B.V. (NL)
Klasa: 011-01/13-01/53
Urbroj: 525-09/0007-16-7
Zagreb, 18. veljače 2016.
Ministar prof. dr. sc. Davor Romić, v. r.
